STATE,COUNTY,STATE_FIPS,COUNTY_FIPS,KERRY_VOTES,KERRY_%,CLINTON_VOTES,CLINTON_%,VOTE_DIFF,PER_DIFF
MICHIGAN,ALCONA,26,001,2871,0.440,1732,0.279,-1139,-0.161
MICHIGAN,ALGER,26,003,2395,0.503,1663,0.368,-732,-0.135
MICHIGAN,ALLEGAN,26,005,19355,0.359,18050,0.322,-1305,-0.037
MICHIGAN,ALPENA,26,007,7407,0.487,4877,0.330,-2530,-0.157
MICHIGAN,ANTRIM,26,009,5072,0.372,4448,0.325,-624,-0.047
MICHIGAN,ARENAC,26,011,4076,0.496,2384,0.308,-1692,-0.188
MICHIGAN,BARAGA,26,013,1660,0.451,1156,0.329,-504,-0.122
MICHIGAN,BARRY,26,015,11312,0.374,9114,0.299,-2198,-0.075
MICHIGAN,BAY,26,017,31049,0.544,21642,0.409,-9407,-0.135
MICHIGAN,BENZIE,26,019,4383,0.448,4108,0.402,-275,-0.046
MICHIGAN,BERRIEN,26,021,32846,0.440,29495,0.409,-3351,-0.031
MICHIGAN,BRANCH,26,023,7004,0.390,5061,0.287,-1943,-0.103
MICHIGAN,CALHOUN,26,025,29891,0.477,24157,0.410,-5734,-0.067
MICHIGAN,CASS,26,027,9537,0.420,7270,0.322,-2267,-0.098
MICHIGAN,CHARLEVOIX,26,029,5729,0.405,5137,0.351,-592,-0.054
MICHIGAN,CHEBOYGAN,26,031,5941,0.428,4302,0.315,-1639,-0.113
MICHIGAN,CHIPPEWA,26,033,7203,0.437,5379,0.346,-1824,-0.091
MICHIGAN,CLARE,26,035,6984,0.491,4249,0.316,-2735,-0.175
MICHIGAN,CLINTON,26,037,15483,0.410,16492,0.406,1009,-0.004
MICHIGAN,CRAWFORD,26,039,3126,0.432,2110,0.308,-1016,-0.124
MICHIGAN,DELTA,26,041,9381,0.488,6436,0.346,-2945,-0.142
MICHIGAN,DICKINSON,26,043,5650,0.417,3923,0.298,-1727,-0.119
MICHIGAN,EATON,26,045,25411,0.456,24938,0.441,-473,-0.015
MICHIGAN,EMMET,26,047,6846,0.394,6972,0.367,126,-0.027
MICHIGAN,GD. TRAVERSE,26,055,18256,0.395,20965,0.403,2709,0.008
MICHIGAN,GENESEE,26,049,128334,0.600,102751,0.520,-25583,-0.080
MICHIGAN,GLADWIN,26,051,6343,0.480,3794,0.303,-2549,-0.177
MICHIGAN,GOGEBIC,26,053,4421,0.523,2925,0.396,-1496,-0.127
MICHIGAN,GRATIOT,26,057,7377,0.425,5666,0.344,-1711,-0.081
MICHIGAN,HILLSDALE,26,059,7123,0.352,4799,0.241,-2324,-0.111
MICHIGAN,HOUGHTON,26,061,6731,0.425,6018,0.382,-713,-0.043
MICHIGAN,HURON,26,063,7629,0.437,4579,0.287,-3050,-0.150
MICHIGAN,INGHAM,26,065,76877,0.578,79110,0.599,2233,0.021
MICHIGAN,IONIA,26,067,10647,0.385,8352,0.309,-2295,-0.076
MICHIGAN,IOSCO,26,069,6557,0.468,4345,0.324,-2212,-0.144
MICHIGAN,IRON,26,071,3215,0.494,2004,0.339,-1211,-0.155
MICHIGAN,ISABELLA,26,073,12334,0.506,11404,0.447,-930,-0.059
MICHIGAN,JACKSON,26,075,31025,0.432,25795,0.368,-5230,-0.064
MICHIGAN,KALAMAZOO,26,077,61462,0.513,67148,0.532,5686,0.019
MICHIGAN,KALKASKA,26,079,3189,0.380,2280,0.258,-909,-0.122
MICHIGAN,KENT,26,081,116909,0.402,138683,0.446,21774,0.044
MICHIGAN,KEWEENAW,26,083,630,0.438,527,0.368,-103,-0.070
MICHIGAN,LAKE,26,085,2675,0.510,1939,0.362,-736,-0.148
MICHIGAN,LAPEER,26,087,18086,0.410,12734,0.282,-5352,-0.128
MICHIGAN,LEELANAU,26,089,6048,0.435,6774,0.455,726,0.020
MICHIGAN,LENAWEE,26,091,20787,0.442,16750,0.362,-4037,-0.080
MICHIGAN,LIVINGSTON,26,093,33991,0.363,34384,0.323,393,-0.040
MICHIGAN,LUCE,26,095,1045,0.369,681,0.263,-364,-0.106
MICHIGAN,MACKINAC,26,097,2819,0.427,2085,0.339,-734,-0.088
MICHIGAN,MACOMB,26,099,196160,0.487,176317,0.420,-19843,-0.068
MICHIGAN,MANISTEE,26,101,6272,0.492,4979,0.393,-1293,-0.099
MICHIGAN,MARQUETTE,26,103,17412,0.536,16042,0.483,-1370,-0.053
MICHIGAN,MASON,26,105,6333,0.433,5281,0.357,-1052,-0.076
MICHIGAN,MECOSTA,26,107,7730,0.440,5827,0.339,-1903,-0.101
MICHIGAN,MENOMINEE,26,109,5326,0.466,3539,0.327,-1787,-0.139
MICHIGAN,MIDLAND,26,111,18355,0.424,15635,0.366,-2720,-0.058
MICHIGAN,MISSAUKEE,26,113,2319,0.312,1565,0.214,-754,-0.099
MICHIGAN,MONROE,26,115,36089,0.487,26863,0.360,-9226,-0.127
MICHIGAN,MONTCALM,26,117,11471,0.429,7874,0.294,-3597,-0.135
MICHIGAN,MONTMORENCY,26,119,2196,0.395,1287,0.257,-909,-0.138
MICHIGAN,MUSKEGON,26,121,44282,0.551,37304,0.478,-6978,-0.073
MICHIGAN,NEWAYGO,26,123,9057,0.396,6212,0.274,-2845,-0.122
MICHIGAN,OAKLAND,26,125,319387,0.497,343070,0.513,23683,0.016
MICHIGAN,OCEANA,26,127,5441,0.443,3973,0.333,-1468,-0.110
MICHIGAN,OGEMAW,26,129,5215,0.483,3030,0.290,-2185,-0.193
MICHIGAN,ONTONAGON,26,131,1863,0.444,1176,0.343,-687,-0.101
MICHIGAN,OSCEOLA,26,133,4467,0.399,2705,0.255,-1762,-0.144
MICHIGAN,OSCODA,26,135,1792,0.406,1044,0.255,-748,-0.151
MICHIGAN,OTSEGO,26,137,4674,0.380,3556,0.282,-1118,-0.098
MICHIGAN,OTTAWA,26,139,35552,0.276,44973,0.313,9421,0.037
MICHIGAN,PRESQUE ISLE,26,141,3432,0.457,2400,0.331,-1032,-0.126
MICHIGAN,ROSCOMMON,26,143,6810,0.474,4287,0.327,-2523,-0.147
MICHIGAN,SAGINAW,26,145,54887,0.534,44396,0.468,-10491,-0.066
MICHIGAN,SANILAC,26,151,7883,0.380,4873,0.253,-3010,-0.127
MICHIGAN,SCHOOLCRAFT,26,153,2137,0.481,1369,0.328,-768,-0.153
MICHIGAN,SHIAWASSEE,26,155,16881,0.461,12546,0.368,-4335,-0.093
MICHIGAN,ST. CLAIR,26,147,36174,0.454,24553,0.315,-11621,-0.139
MICHIGAN,ST. JOSEPH,26,149,9648,0.382,7526,0.314,-2122,-0.068
MICHIGAN,TUSCOLA,26,157,12631,0.446,7429,0.287,-5202,-0.159
MICHIGAN,VAN BUREN,26,159,16151,0.473,13258,0.398,-2893,-0.075
MICHIGAN,WASHTENAW,26,161,109953,0.635,128483,0.676,18530,0.041
MICHIGAN,WAYNE,26,163,600047,0.694,519444,0.664,-80603,-0.030
MICHIGAN,WEXFORD,26,165,6034,0.398,4436,0.289,-1598,-0.109
NEW-MEXICO,LEA,35,025,3646,0.201,3930,0.222,284,0.021
NEW-MEXICO,UNION,35,059,411,0.219,320,0.188,-91,-0.031
NEW-MEXICO,CURRY,35,009,3541,0.248,3121,0.233,-420,-0.015
NEW-MEXICO,CATRON,35,003,551,0.276,427,0.208,-124,-0.068
NEW-MEXICO,DEBACA,35,011,281,0.283,193,0.212,-88,-0.071
NEW-MEXICO,ROOSEVELT,35,041,2082,0.291,1454,0.244,-628,-0.047
NEW-MEXICO,CHAVES,35,005,6726,0.310,5534,0.273,-1192,-0.037
NEW-MEXICO,OTERO,35,035,6433,0.310,6124,0.305,-309,-0.005
NEW-MEXICO,LINCOLN,35,027,2822,0.313,2331,0.262,-491,-0.051
NEW-MEXICO,SANJUAN,35,045,14843,0.330,12865,0.279,-1978,-0.051
NEW-MEXICO,EDDY,35,015,6880,0.339,5033,0.256,-1847,-0.083
NEW-MEXICO,QUAY,35,037,1422,0.345,1017,0.285,-405,-0.060
NEW-MEXICO,TORRANCE,35,057,2386,0.367,1785,0.282,-601,-0.085
NEW-MEXICO,SIERRA,35,051,1926,0.373,1612,0.311,-314,-0.062
NEW-MEXICO,HARDING,35,021,259,0.402,156,0.296,-103,-0.106
NEW-MEXICO,VALENCIA,35,061,11270,0.433,10841,0.393,-429,-0.040
NEW-MEXICO,HIDALGO,35,023,861,0.438,784,0.419,-77,-0.019
NEW-MEXICO,LUNA,35,029,3340,0.440,3195,0.438,-145,-0.002
NEW-MEXICO,LOSALAMOS,35,028,5206,0.465,5562,0.511,356,0.046
NEW-MEXICO,COLFAX,35,007,2824,0.473,2129,0.399,-695,-0.074
NEW-MEXICO,SANDOVAL,35,043,21421,0.481,27707,0.449,6286,-0.032
NEW-MEXICO,DONAANA,35,013,31762,0.513,37947,0.537,6185,0.024
NEW-MEXICO,BERNALILLO,35,001,132252,0.515,143417,0.522,11165,0.007
NEW-MEXICO,SOCORRO,35,053,4025,0.513,3313,0.482,-712,-0.031
NEW-MEXICO,CIBOLA,35,006,3913,0.523,3741,0.464,-172,-0.059
NEW-MEXICO,GRANT,35,017,7095,0.530,6276,0.490,-819,-0.040
NEW-MEXICO,GUADALUPE,35,019,1340,0.591,970,0.531,-370,-0.060
NEW-MEXICO,MCKINLEY,35,031,13051,0.633,13576,0.626,525,-0.007
NEW-MEXICO,RIOARRIBA,35,039,9753,0.650,9592,0.645,-161,-0.005
NEW-MEXICO,MORA,35,033,1876,0.664,1536,0.629,-340,-0.035
NEW-MEXICO,SANTAFE,35,049,47074,0.711,50793,0.711,3719,0.000
NEW-MEXICO,SANMIGUEL,35,047,8683,0.717,7285,0.678,-1398,-0.039
NEW-MEXICO,TAOS,35,055,10987,0.741,10668,0.699,-319,-0.042
MAINE,ANDROSCOGGIN,23,001,30503,0.544,23009,0.414,-7494,-0.130
MAINE,AROOSTOCK,23,003,19569,0.519,13386,0.381,-6183,-0.138
MAINE,CUMBERLAND,23,005,94846,0.582,102981,0.599,8135,0.017
MAINE,FRANKLIN,23,007,9458,0.548,7016,0.426,-2442,-0.122
MAINE,HANCOCK,23,009,18048,0.545,16117,0.502,-1931,-0.043
MAINE,KENNEBEC,23,011,35616,0.533,29302,0.443,-6314,-0.090
MAINE,KNOX,23,013,12690,0.546,12443,0.538,-247,-0.008
MAINE,LINCOLN,23,015,11351,0.513,10241,0.476,-1110,-0.037
MAINE,OXFORD,23,017,16618,0.527,12172,0.390,-4446,-0.137
MAINE,PENOBSCOT,23,019,40386,0.492,32838,0.408,-7548,-0.084
MAINE,PISCATAQUIS,23,021,4409,0.444,3098,0.337,-1311,-0.107
MAINE,SAGADAHOC,23,023,11114,0.527,10664,0.493,-450,-0.034
MAINE,SOMERSET,23,025,13586,0.500,9092,0.349,-4494,-0.151
MAINE,WALDO,23,027,11555,0.518,10440,0.460,-1115,-0.058
MAINE,WASHINGTON,23,029,8391,0.485,6075,0.371,-2316,-0.114
MAINE,YORK,23,031,58702,0.533,55844,0.489,-2858,-0.044
ALABAMA,AUTAUGA,01,001,4758,0.237,5936,0.238,1178,0.001
ALABAMA,BALDWIN,01,003,15599,0.225,18458,0.194,2859,-0.031
ALABAMA,BARBOUR,01,005,4832,0.448,4871,0.465,39,0.017
ALABAMA,BIBB,01,007,2089,0.275,1874,0.212,-215,-0.063
ALABAMA,BLOUNT,01,009,3938,0.183,2156,0.084,-1782,-0.099
ALABAMA,BULLOCK,01,011,3210,0.681,3530,0.749,320,0.068
ALABAMA,BUTLER,01,013,3413,0.406,3726,0.427,313,0.021
ALABAMA,CALHOUN,01,015,15083,0.333,13242,0.277,-1841,-0.056
ALABAMA,CHAMBERS,01,017,5347,0.410,5784,0.416,437,0.006
ALABAMA,CHEROKEE,01,019,3040,0.336,1547,0.144,-1493,-0.192
ALABAMA,CHILTON,01,021,3778,0.226,2911,0.158,-867,-0.068
ALABAMA,CHOCTAW,01,023,3303,0.457,3109,0.426,-194,-0.031
ALABAMA,CLARKE,01,025,4627,0.406,5749,0.441,1122,0.035
ALABAMA,CLAY,01,027,1893,0.288,1237,0.187,-656,-0.101
ALABAMA,CLEBURNE,01,029,1391,0.240,684,0.104,-707,-0.136
ALABAMA,COFFEE,01,031,4480,0.254,4221,0.203,-259,-0.051
ALABAMA,COLBERT,01,033,10598,0.443,7312,0.293,-3286,-0.150
ALABAMA,CONECUH,01,035,2719,0.452,3080,0.468,361,0.016
ALABAMA,COOSA,01,037,2055,0.411,1782,0.339,-273,-0.072
ALABAMA,COVINGTON,01,039,3423,0.234,2387,0.150,-1036,-0.084
ALABAMA,CRENSHAW,01,041,1698,0.309,1664,0.266,-34,-0.043
ALABAMA,CULLMAN,01,043,8045,0.229,3798,0.100,-4247,-0.129
ALABAMA,DALE,01,045,4484,0.246,4413,0.235,-71,-0.011
ALABAMA,DALLAS,01,047,11175,0.602,12836,0.683,1661,0.081
ALABAMA,DEKALB,01,049,7092,0.294,3622,0.140,-3470,-0.154
ALABAMA,ELMORE,01,051,6471,0.226,8443,0.227,1972,0.001
ALABAMA,ESCAMBIA,01,053,3814,0.308,4605,0.310,791,0.002
ALABAMA,ETOWAH,01,055,15328,0.359,10442,0.236,-4886,-0.123
ALABAMA,FAYETTE,01,057,2408,0.301,1362,0.165,-1046,-0.136
ALABAMA,FRANKLIN,01,059,4514,0.368,2197,0.182,-2317,-0.186
ALABAMA,GENEVA,01,061,2113,0.201,1525,0.130,-588,-0.071
ALABAMA,GREENE,01,063,3764,0.793,4013,0.822,249,0.029
ALABAMA,HALE,01,065,4631,0.583,4775,0.594,144,0.011
ALABAMA,HENRY,01,067,2452,0.333,2292,0.284,-160,-0.049
ALABAMA,HOUSTON,01,069,9144,0.253,10664,0.250,1520,-0.003
ALABAMA,JACKSON,01,071,8635,0.425,3673,0.175,-4962,-0.250
ALABAMA,JEFFERSON,01,073,132286,0.452,156873,0.516,24587,0.064
ALABAMA,LAMAR,01,075,1956,0.284,1036,0.149,-920,-0.135
ALABAMA,LAUDERDALE,01,077,14628,0.394,9952,0.252,-4676,-0.142
ALABAMA,LAWRENCE,01,079,6155,0.440,3627,0.245,-2528,-0.195
ALABAMA,LEE,01,081,16227,0.364,21230,0.359,5003,-0.005
ALABAMA,LIMESTONE,01,083,9126,0.314,9468,0.235,342,-0.079
ALABAMA,LOWNDES,01,085,4233,0.703,4883,0.731,650,0.028
ALABAMA,MACON,01,087,7800,0.829,7566,0.828,-234,-0.001
ALABAMA,MADISON,01,089,52644,0.402,62822,0.384,10178,-0.018
ALABAMA,MARENGO,01,091,5037,0.488,5615,0.511,578,0.023
ALABAMA,MARION,01,093,3808,0.296,1432,0.110,-2376,-0.186
ALABAMA,MARSHALL,01,095,8452,0.268,4917,0.139,-3535,-0.129
ALABAMA,MOBILE,01,097,63732,0.407,72186,0.418,8454,0.011
ALABAMA,MONROE,01,099,3666,0.385,4332,0.422,666,0.037
ALABAMA,MONTGOMERY,01,101,45160,0.504,58916,0.614,13756,0.110
ALABAMA,MORGAN,01,103,14131,0.301,11254,0.222,-2877,-0.079
ALABAMA,PERRY,01,105,3767,0.682,3824,0.725,57,0.043
ALABAMA,PICKENS,01,107,3915,0.429,3972,0.416,57,-0.013
ALABAMA,PIKE,01,109,4334,0.365,5056,0.384,722,0.019
ALABAMA,RANDOLPH,01,111,2817,0.313,2291,0.225,-526,-0.088
ALABAMA,RUSSELL,01,113,8375,0.498,9579,0.497,1204,-0.001
ALABAMA,STCLAIR,01,115,5456,0.187,5589,0.146,133,-0.041
ALABAMA,SHELBY,01,117,14850,0.188,22977,0.227,8127,0.039
ALABAMA,SUMTER,01,119,4527,0.704,4746,0.740,219,0.036
ALABAMA,TALLADEGA,01,121,11374,0.380,12121,0.363,747,-0.017
ALABAMA,TALLAPOOSA,01,123,5451,0.304,5519,0.283,68,-0.021
ALABAMA,TUSCALOOSA,01,125,26447,0.379,31762,0.384,5315,0.005
ALABAMA,WALKER,01,127,9016,0.318,4497,0.153,-4519,-0.165
ALABAMA,WASHINGTON,01,129,3145,0.381,2374,0.278,-771,-0.103
ALABAMA,WILCOX,01,131,3838,0.675,4339,0.709,501,0.034
ALABAMA,WINSTON,01,133,2236,0.215,872,0.085,-1364,-0.130
ARIZONA,GRAHAM,04,009,3185,0.297,3301,0.269,116,-0.028
ARIZONA,MOHAVE,04,015,20503,0.354,17455,0.218,-3048,-0.136
ARIZONA,LAPAZ,04,012,1849,0.365,1575,0.265,-274,-0.100
ARIZONA,GREENLEE,04,011,1146,0.374,1092,0.331,-54,-0.043
ARIZONA,YAVAPAI,04,025,33127,0.378,35590,0.311,2463,-0.067
ARIZONA,COCHISE,04,003,17514,0.393,17450,0.349,-64,-0.044
ARIZONA,GILA,04,007,8314,0.399,7003,0.311,-1311,-0.088
ARIZONA,YUMA,04,027,16032,0.416,24605,0.464,8573,0.048
ARIZONA,PINAL,04,021,27252,0.422,47892,0.370,20640,-0.052
ARIZONA,MARICOPA,04,013,504849,0.423,702907,0.448,198058,0.025
ARIZONA,NAVAJO,04,017,14815,0.457,16459,0.408,1644,-0.049
ARIZONA,PIMA,04,019,193128,0.526,224661,0.533,31533,0.007
ARIZONA,COCONINO,04,005,29243,0.558,32404,0.542,3161,-0.016
ARIZONA,SANTACRUZ,04,023,6909,0.592,11690,0.711,4781,0.119
ARIZONA,APACHE,04,001,15658,0.646,17083,0.618,1425,-0.028
ARKANSAS,ARKANSAS,05,001,3110,0.448,1939,0.312,-1171,-0.136
ARKANSAS,ASHLEY,05,003,3881,0.456,2408,0.298,-1473,-0.158
ARKANSAS,BAXTER,05,005,7129,0.385,4169,0.211,-2960,-0.174
ARKANSAS,BENTON,05,007,20756,0.305,28005,0.289,7249,-0.016
ARKANSAS,BOONE,05,009,4640,0.314,2926,0.182,-1714,-0.132
ARKANSAS,BRADLEY,05,011,2206,0.519,1317,0.361,-889,-0.158
ARKANSAS,CALHOUN,05,013,939,0.408,639,0.282,-300,-0.126
ARKANSAS,CARROLL,05,015,4161,0.397,3342,0.311,-819,-0.086
ARKANSAS,CHICOT,05,017,2993,0.629,2350,0.563,-643,-0.066
ARKANSAS,CLARK,05,019,4990,0.542,3620,0.425,-1370,-0.117
ARKANSAS,CLAY,05,021,3264,0.535,1199,0.231,-2065,-0.304
ARKANSAS,CLEBURNE,05,023,4517,0.384,2101,0.174,-2416,-0.210
ARKANSAS,CLEVELAND,05,025,1450,0.415,723,0.216,-727,-0.199
ARKANSAS,COLUMBIA,05,027,4108,0.415,3140,0.353,-968,-0.062
ARKANSAS,CONWAY,05,029,3982,0.493,2656,0.335,-1326,-0.158
ARKANSAS,CRAIGHEAD,05,031,13665,0.459,10538,0.296,-3127,-0.163
ARKANSAS,CRAWFORD,05,033,6764,0.332,4488,0.200,-2276,-0.132
ARKANSAS,CRITTENDEN,05,035,8277,0.541,8410,0.527,133,-0.014
ARKANSAS,CROSS,05,037,3135,0.443,1999,0.291,-1136,-0.152
ARKANSAS,DALLAS,05,039,1671,0.493,1165,0.420,-506,-0.073
ARKANSAS,DESHA,05,041,2851,0.614,2228,0.523,-623,-0.091
ARKANSAS,DREW,05,043,2952,0.472,2365,0.359,-587,-0.113
ARKANSAS,FAULKNER,05,045,14538,0.396,14629,0.308,91,-0.088
ARKANSAS,FRANKLIN,05,047,3008,0.413,1376,0.203,-1632,-0.210
ARKANSAS,FULTON,05,049,2370,0.478,1067,0.224,-1303,-0.254
ARKANSAS,GARLAND,05,051,18040,0.449,12311,0.302,-5729,-0.147
ARKANSAS,GRANT,05,053,2524,0.373,1373,0.184,-1151,-0.189
ARKANSAS,GREENE,05,055,6564,0.470,3071,0.210,-3493,-0.260
ARKANSAS,HEMPSTEAD,05,057,3817,0.512,2377,0.337,-1440,-0.175
ARKANSAS,HOTSPRING,05,059,5901,0.489,3149,0.264,-2752,-0.225
ARKANSAS,HOWARD,05,061,2166,0.438,1351,0.289,-815,-0.149
ARKANSAS,INDEPENDENCE,05,063,5443,0.418,2881,0.212,-2562,-0.206
ARKANSAS,IZARD,05,065,2586,0.471,1113,0.204,-1473,-0.267
ARKANSAS,JACKSON,05,067,3515,0.565,1583,0.307,-1932,-0.258
ARKANSAS,JEFFERSON,05,069,19675,0.645,15772,0.609,-3903,-0.036
ARKANSAS,JOHNSON,05,071,3622,0.450,2427,0.266,-1195,-0.184
ARKANSAS,LAFAYETTE,05,073,1567,0.491,1032,0.361,-535,-0.130
ARKANSAS,LAWRENCE,05,075,3544,0.536,1263,0.222,-2281,-0.314
ARKANSAS,LEE,05,077,2548,0.625,1735,0.573,-813,-0.052
ARKANSAS,LINCOLN,05,079,2149,0.523,1252,0.327,-897,-0.196
ARKANSAS,LITTLERIVER,05,081,2677,0.506,1397,0.267,-1280,-0.239
ARKANSAS,LOGAN,05,083,3361,0.393,1715,0.217,-1646,-0.176
ARKANSAS,LONOKE,05,085,7454,0.338,5664,0.209,-1790,-0.129
ARKANSAS,MADISON,05,087,2421,0.379,1588,0.232,-833,-0.147
ARKANSAS,MARION,05,089,2602,0.379,1434,0.202,-1168,-0.177
ARKANSAS,MILLER,05,091,6139,0.418,4273,0.266,-1866,-0.152
ARKANSAS,MISSISSIPPI,05,093,7593,0.536,5670,0.429,-1923,-0.107
ARKANSAS,MONROE,05,095,2049,0.559,1312,0.455,-737,-0.104
ARKANSAS,MONTGOMERY,05,097,1524,0.385,1312,0.455,-737,-0.104
ARKANSAS,NEVADA,05,099,1694,0.487,1157,0.356,-537,-0.131
ARKANSAS,NEWTON,05,101,1506,0.344,699,0.186,-807,-0.158
ARKANSAS,OUACHITA,05,103,5188,0.487,4321,0.435,-867,-0.052
ARKANSAS,PERRY,05,105,1921,0.434,1049,0.244,-872,-0.190
ARKANSAS,PHILLIPS,05,107,5642,0.636,4310,0.620,-1332,-0.016
ARKANSAS,PIKE,05,109,1310,0.389,685,0.172,-625,-0.217
ARKANSAS,POINSETT,05,111,4069,0.527,1880,0.243,-2189,-0.284
ARKANSAS,POLK,05,113,2473,0.317,1212,0.147,-1261,-0.170
ARKANSAS,POPE,05,115,7100,0.340,5000,0.222,-2100,-0.118
ARKANSAS,PRAIRIE,05,117,1562,0.431,814,0.236,-748,-0.195
ARKANSAS,PULASKI,05,119,84532,0.550,89574,0.561,5042,0.011
ARKANSAS,RANDOLPH,05,121,3412,0.512,1425,0.223,-1987,-0.289
ARKANSAS,STFRANCIS,05,123,5684,0.593,4031,0.543,-1653,-0.050
ARKANSAS,SALINE,05,125,14153,0.359,13256,0.254,-897,-0.105
ARKANSAS,SCOTT,05,127,1473,0.365,602,0.172,-871,-0.193
ARKANSAS,SEARCY,05,129,1370,0.343,601,0.161,-769,-0.182
ARKANSAS,SEBASTIAN,05,131,16479,0.373,12300,0.276,-4179,-0.097
ARKANSAS,SEVIER,05,133,2035,0.442,1075,0.236,-960,-0.206
ARKANSAS,SHARP,05,135,3265,0.437,1472,0.203,-1793,-0.234
ARKANSAS,STONE,05,137,2255,0.406,1203,0.216,-1052,-0.190
ARKANSAS,UNION,05,139,7071,0.397,5855,0.347,-1216,-0.050
ARKANSAS,VANBUREN,05,141,3310,0.449,1549,0.211,-1761,-0.238
ARKANSAS,WASHINGTON,05,143,27597,0.431,33366,0.408,5769,-0.023
ARKANSAS,WHITE,05,145,9129,0.345,5170,0.185,-3959,-0.160
ARKANSAS,WOODRUFF,05,147,1972,0.652,1118,0.435,-854,-0.217
ARKANSAS,YELL,05,149,2913,0.437,1480,0.230,-1433,-0.207
CALIFORNIA,SANFRANCISCO,06,075,296772,0.830,345084,0.845,48312,0.015
CALIFORNIA,ALAMEDA,06,001,422585,0.752,514842,0.781,92257,0.029
CALIFORNIA,MARIN,06,041,99070,0.732,108707,0.773,9637,0.041
CALIFORNIA,SANTACRUZ,06,087,89102,0.730,95249,0.733,6147,0.003
CALIFORNIA,SANMATEO,06,081,197922,0.695,237882,0.757,39960,0.062
CALIFORNIA,SONOMA,06,097,148261,0.672,160435,0.688,12174,0.016
CALIFORNIA,SANTACLARA,06,085,386100,0.639,511684,0.727,125584,0.088
CALIFORNIA,MENDOCINO,06,045,24385,0.635,22079,0.582,-2306,-0.052
CALIFORNIA,LOSANGELES,06,037,1907736,0.631,2464364,0.718,556628,0.087
CALIFORNIA,CONTRACOSTA,06,013,257254,0.623,319287,0.675,62033,0.052
CALIFORNIA,MONTEREY,06,053,75241,0.604,89088,0.668,13847,0.064
CALIFORNIA,NAPA,06,055,33666,0.595,39199,0.639,5533,0.044
CALIFORNIA,YOLO,06,113,42885,0.593,54752,0.667,11867,0.074
CALIFORNIA,HUMBOLDT,06,023,37988,0.577,33200,0.553,-4788,-0.024
CALIFORNIA,SOLANO,06,095,85096,0.572,102360,0.609,17264,0.037
CALIFORNIA,ALPINE,06,003,373,0.532,334,0.555,-39,0.023
CALIFORNIA,SANTABARBARA,06,083,90314,0.532,107142,0.599,16828,0.067
CALIFORNIA,LAKE,06,033,13141,0.532,11496,0.466,-1645,-0.066
CALIFORNIA,SANBENITO,06,069,9851,0.526,12521,0.566,2670,0.040
CALIFORNIA,IMPERIAL,06,025,17964,0.524,32667,0.679,14703,0.155
CALIFORNIA,SACRAMENTO,06,067,236657,0.495,326023,0.580,89366,0.085
CALIFORNIA,MONO,06,051,2628,0.492,2773,0.525,145,0.033
CALIFORNIA,VENTURA,06,111,148859,0.475,194402,0.546,45543,0.071
CALIFORNIA,SANDIEGO,06,073,526437,0.464,735476,0.563,209039,0.099
CALIFORNIA,SANJOAQUIN,06,077,87012,0.458,121124,0.534,34112,0.076
CALIFORNIA,SANLUISOBISPO,06,079,58742,0.455,67107,0.489,8365,0.034
CALIFORNIA,NEVADA,06,057,24220,0.449,26053,0.474,1833,0.025
CALIFORNIA,BUTTE,06,007,42448,0.441,41567,0.429,-881,-0.012
CALIFORNIA,SANBERNARDINO,06,071,227789,0.436,340833,0.521,113044,0.085
CALIFORNIA,TRINITY,06,105,2782,0.427,2214,0.383,-568,-0.044
CALIFORNIA,MERCED,06,047,24491,0.423,37317,0.527,12826,0.104
CALIFORNIA,FRESNO,06,019,103154,0.417,141341,0.492,38187,0.075
CALIFORNIA,DELNORTE,06,015,3892,0.413,3485,0.365,-407,-0.048
CALIFORNIA,RIVERSIDE,06,065,228806,0.410,373695,0.497,144889,0.087
CALIFORNIA,STANISLAUS,06,099,58829,0.404,81647,0.468,22818,0.064
CALIFORNIA,ORANGE,06,059,419239,0.390,609961,0.509,190722,0.119
CALIFORNIA,INYO,06,027,3350,0.389,3155,0.386,-195,-0.003
CALIFORNIA,TUOLUMNE,06,109,10104,0.385,9123,0.352,-981,-0.033
CALIFORNIA,SISKIYOU,06,093,7880,0.377,7234,0.353,-646,-0.024
CALIFORNIA,MARIPOSA,06,043,3251,0.375,3122,0.352,-129,-0.023
CALIFORNIA,ELDORADO,06,017,32242,0.373,36404,0.383,4162,0.010
CALIFORNIA,CALAVERAS,06,009,8286,0.371,7944,0.338,-342,-0.033
CALIFORNIA,PLUMAS,06,063,4129,0.369,3459,0.351,-670,-0.018
CALIFORNIA,AMADOR,06,005,6541,0.366,6004,0.334,-537,-0.032
CALIFORNIA,PLACER,06,061,55573,0.363,73509,0.395,17936,0.032
CALIFORNIA,MADERA,06,039,13481,0.347,17029,0.391,3548,0.044
CALIFORNIA,KINGS,06,031,10833,0.337,13617,0.397,2784,0.060
CALIFORNIA,SIERRA,06,091,646,0.332,601,0.323,-45,-0.009
CALIFORNIA,TULARE,06,107,32494,0.329,47585,0.417,15091,0.088
CALIFORNIA,KERN,06,029,68603,0.325,98689,0.404,30086,0.079
CALIFORNIA,TEHAMA,06,103,7504,0.320,6809,0.285,-695,-0.035
CALIFORNIA,SUTTER,06,101,9602,0.319,13076,0.387,3474,0.069
CALIFORNIA,GLENN,06,021,2995,0.317,3065,0.324,70,0.007
CALIFORNIA,YUBA,06,115,5687,0.316,7910,0.344,2223,0.028
CALIFORNIA,COLUSA,06,011,1947,0.316,2661,0.397,714,0.081
CALIFORNIA,SHASTA,06,089,24339,0.313,22301,0.275,-2038,-0.038
CALIFORNIA,LASSEN,06,035,3158,0.276,2224,0.208,-934,-0.068
CALIFORNIA,MODOC,06,049,1149,0.257,877,0.228,-272,-0.029
COLORADO,ADAMS,08,001,69122,0.506,96558,0.499,27436,-0.007
COLORADO,ALAMOSA,08,003,3017,0.480,3189,0.460,172,-0.020
COLORADO,ARAPAHOE,08,005,110262,0.475,159885,0.528,49623,0.053
COLORADO,ARCHULETA,08,007,2141,0.367,2500,0.341,359,-0.026
COLORADO,BACA,08,009,483,0.221,283,0.131,-200,-0.090
COLORADO,BENT,08,011,785,0.364,590,0.306,-195,-0.058
COLORADO,BOULDER,08,013,105564,0.663,132334,0.703,26770,0.040
COLORADO,BROOMFIELD,08,014,10935,0.471,19731,0.524,8796,0.053
COLORADO,CHAFFEE,08,015,3766,0.429,4888,0.434,1122,0.005
COLORADO,CHEYENNE,08,017,198,0.175,132,0.120,-66,-0.055
COLORADO,CLEARCREEK,08,019,2989,0.533,2729,0.465,-260,-0.068
COLORADO,CONEJOS,08,021,1894,0.498,1771,0.440,-123,-0.058
COLORADO,COSTILLA,08,023,1170,0.665,1125,0.609,-45,-0.056
COLORADO,CROWLEY,08,025,478,0.320,339,0.222,-139,-0.098
COLORADO,CUSTER,08,027,739,0.304,797,0.260,58,-0.044
COLORADO,DELTA,08,029,4224,0.298,4087,0.243,-137,-0.055
COLORADO,DENVER,08,031,166135,0.696,244551,0.737,78416,0.041
COLORADO,DOLORES,08,033,333,0.291,242,0.193,-91,-0.098
COLORADO,DOUGLAS,08,035,39661,0.327,68657,0.366,28996,0.039
COLORADO,EAGLE,08,037,9744,0.526,14099,0.559,4355,0.033
COLORADO,ELPASO,08,041,77648,0.321,108010,0.339,30362,0.018
COLORADO,ELBERT,08,039,2834,0.249,3134,0.196,300,-0.053
COLORADO,FREMONT,08,043,5933,0.320,5297,0.241,-636,-0.079
COLORADO,GARFIELD,08,045,9228,0.447,11271,0.426,2043,-0.021
COLORADO,GILPIN,08,047,1807,0.565,1634,0.457,-173,-0.108
COLORADO,GRAND,08,049,3243,0.426,3358,0.391,115,-0.035
COLORADO,GUNNISON,08,051,4782,0.568,5128,0.545,346,-0.023
COLORADO,HINSDALE,08,053,236,0.392,197,0.334,-39,-0.058
COLORADO,HUERFANO,08,055,1663,0.489,1633,0.432,-30,-0.057
COLORADO,JACKSON,08,057,210,0.225,171,0.199,-39,-0.026
COLORADO,JEFFERSON,08,059,126558,0.466,160776,0.489,34218,0.023
COLORADO,KIOWA,08,061,172,0.193,91,0.106,-81,-0.087
COLORADO,KITCARSON,08,063,729,0.208,536,0.145,-193,-0.063
COLORADO,LAPLATA,08,067,13409,0.526,15525,0.498,2116,-0.028
COLORADO,LAKE,08,065,1623,0.550,1616,0.505,-7,-0.045
COLORADO,LARIMER,08,069,68266,0.466,93113,0.475,24847,0.009
COLORADO,LASANIMAS,08,071,3300,0.501,2650,0.390,-650,-0.111
COLORADO,LINCOLN,08,073,503,0.215,409,0.168,-94,-0.047
COLORADO,LOGAN,08,075,2491,0.284,1851,0.190,-640,-0.094
COLORADO,MESA,08,077,19564,0.316,21729,0.280,2165,-0.036
COLORADO,MINERAL,08,079,227,0.367,237,0.363,10,-0.004
COLORADO,MOFFAT,08,081,1355,0.237,874,0.134,-481,-0.103
COLORADO,MONTEZUMA,08,083,3867,0.351,3973,0.309,106,-0.042
COLORADO,MONTROSE,08,085,4776,0.294,5466,0.258,690,-0.036
COLORADO,MORGAN,08,087,3039,0.306,3151,0.263,112,-0.043
COLORADO,OTERO,08,089,3164,0.387,2943,0.348,-221,-0.039
COLORADO,OURAY,08,091,1278,0.470,1697,0.513,419,0.043
COLORADO,PARK,08,093,3445,0.412,3421,0.328,-24,-0.084
COLORADO,PHILLIPS,08,095,582,0.250,436,0.187,-146,-0.063
COLORADO,PITKIN,08,097,6335,0.684,7333,0.697,998,0.013
COLORADO,PROWERS,08,099,1308,0.276,1186,0.236,-122,-0.040
COLORADO,PUEBLO,08,101,35369,0.526,35875,0.456,506,-0.070
COLORADO,RIOBLANCO,08,103,566,0.188,436,0.126,-130,-0.062
COLORADO,RIOGRANDE,08,105,2006,0.363,2001,0.362,-5,-0.001
COLORADO,ROUTT,08,107,6392,0.543,7600,0.543,1208,0.000
COLORADO,SAGUACHE,08,109,1594,0.569,1417,0.500,-177,-0.069
COLORADO,SANJUAN,08,111,253,0.521,265,0.524,12,0.003
COLORADO,SANMIGUEL,08,113,2876,0.716,2975,0.687,99,-0.029
COLORADO,SEDGWICK,08,115,374,0.275,267,0.196,-107,-0.079
COLORADO,SUMMIT,08,117,8144,0.593,9557,0.591,1413,-0.002
COLORADO,TELLER,08,119,3556,0.300,3603,0.249,47,-0.051
COLORADO,WASHINGTON,08,121,455,0.180,296,0.108,-159,-0.072
COLORADO,WELD,08,123,31868,0.359,46519,0.343,14651,-0.016
COLORADO,YUMA,08,125,1064,0.233,726,0.152,-338,-0.081
CONNECTICUT,HARTFORD,09,003,229902,0.587,240403,0.591,10501,0.004
CONNECTICUT,MIDDLESEX,09,007,47292,0.563,45357,0.512,-1935,-0.051
CONNECTICUT,NEWLONDON,09,011,66062,0.558,62278,0.504,-3784,-0.054
CONNECTICUT,TOLLAND,09,013,39146,0.546,38506,0.497,-640,-0.049
CONNECTICUT,NEWHAVEN,09,009,199060,0.543,205609,0.542,6549,-0.001
CONNECTICUT,WINDHAM,09,015,25477,0.521,21792,0.429,-3685,-0.092
CONNECTICUT,FAIRFIELD,09,001,205902,0.514,243852,0.579,37950,0.065
CONNECTICUT,LITCHFIELD,09,005,44647,0.462,39775,0.408,-4872,-0.054
DELAWARE,NEWCASTLE,10,003,146179,0.605,162919,0.620,16740,0.015
DELAWARE,KENT,10,001,23875,0.426,33351,0.446,9476,0.020
DELAWARE,SUSSEX,10,005,30098,0.387,39333,0.371,9235,-0.016
FLORIDA,ALACHUA,12,001,62504,0.561,75820,0.583,13316,0.022
FLORIDA,BAKER,12,003,2180,0.219,2112,0.166,-68,-0.053
FLORIDA,BAY,12,005,21068,0.281,21797,0.247,729,-0.034
FLORIDA,BRADFORD,12,007,3244,0.299,2924,0.241,-320,-0.058
FLORIDA,BREVARD,12,009,110309,0.416,119679,0.376,9370,-0.040
FLORIDA,BROWARD,12,011,453873,0.642,553320,0.661,99447,0.019
FLORIDA,CALHOUN,12,013,2116,0.355,1241,0.203,-875,-0.152
FLORIDA,CHARLOTTE,12,015,34256,0.429,33445,0.344,-811,-0.085
FLORIDA,CITRUS,12,017,29277,0.421,22789,0.283,-6488,-0.138
FLORIDA,CLAY,12,019,18971,0.233,27822,0.259,8851,0.026
FLORIDA,COLLIER,12,021,43892,0.341,61085,0.354,17193,0.013
FLORIDA,COLUMBIA,12,023,8031,0.321,7601,0.263,-430,-0.058
FLORIDA,DESOTO,12,027,3913,0.411,3781,0.347,-132,-0.064
FLORIDA,DIXIE,12,029,1960,0.304,1270,0.175,-690,-0.129
FLORIDA,DUVAL,12,031,158610,0.416,205704,0.471,47094,0.055
FLORIDA,ESCAMBIA,12,033,48329,0.337,57461,0.373,9132,0.036
FLORIDA,FLAGLER,12,035,18578,0.483,22026,0.380,3448,-0.103
FLORIDA,FRANKLIN,12,037,2401,0.405,1744,0.288,-657,-0.117
FLORIDA,GADSDEN,12,039,14629,0.697,15020,0.676,391,-0.021
FLORIDA,GILCHRIST,12,041,2017,0.288,1458,0.172,-559,-0.116
FLORIDA,GLADES,12,043,1718,0.410,1271,0.290,-447,-0.120
FLORIDA,GULF,12,045,2407,0.331,1720,0.235,-687,-0.096
FLORIDA,HAMILTON,12,047,2260,0.445,1904,0.347,-356,-0.098
FLORIDA,HARDEE,12,049,2149,0.296,2149,0.281,0,-0.015
FLORIDA,HENDRY,12,051,3960,0.405,4615,0.413,655,0.008
FLORIDA,HERNANDO,12,053,37187,0.462,31795,0.336,-5392,-0.126
FLORIDA,HIGHLANDS,12,055,15347,0.370,14937,0.325,-410,-0.045
FLORIDA,HILLSBOROUGH,12,057,214132,0.462,307896,0.510,93764,0.048
FLORIDA,HOLMES,12,059,1810,0.218,853,0.100,-957,-0.118
FLORIDA,INDIANRIVER,12,061,23956,0.390,29043,0.360,5087,-0.030
FLORIDA,JACKSON,12,063,7555,0.381,6397,0.302,-1158,-0.079
FLORIDA,JEFFERSON,12,065,4135,0.553,3541,0.461,-594,-0.092
FLORIDA,LAFAYETTE,12,067,845,0.254,518,0.152,-327,-0.102
FLORIDA,LAKE,12,069,48221,0.389,62838,0.369,14617,-0.020
FLORIDA,LEE,12,071,93860,0.390,124908,0.379,31048,-0.011
FLORIDA,LEON,12,073,83873,0.615,92068,0.598,8195,-0.017
FLORIDA,LEVY,12,075,6074,0.365,5101,0.262,-973,-0.103
FLORIDA,LIBERTY,12,077,1070,0.354,651,0.197,-419,-0.157
FLORIDA,MADISON,12,079,4050,0.488,3526,0.413,-524,-0.075
FLORIDA,MANATEE,12,081,61262,0.427,71224,0.394,9962,-0.033
FLORIDA,MARION,12,083,57271,0.410,62041,0.353,4770,-0.057
FLORIDA,MARTIN,12,085,30208,0.417,30185,0.348,-23,-0.069
FLORIDA,MIAMI-DADE,12,086,409732,0.529,624146,0.632,214414,0.103
FLORIDA,MONROE,12,087,19654,0.497,18971,0.441,-683,-0.056
FLORIDA,NASSAU,12,089,8573,0.262,10869,0.231,2296,-0.031
FLORIDA,OKALOOSA,12,091,19368,0.216,23780,0.233,4412,0.017
FLORIDA,OKEECHOBEE,12,093,5153,0.423,3959,0.288,-1194,-0.135
FLORIDA,ORANGE,12,095,193354,0.498,329894,0.598,136540,0.100
FLORIDA,OSCEOLA,12,097,38633,0.470,85458,0.604,46825,0.134
FLORIDA,PALMBEACH,12,099,328687,0.604,374673,0.562,45986,-0.042
FLORIDA,PASCO,12,101,84749,0.444,90142,0.371,5393,-0.073
FLORIDA,PINELLAS,12,103,225460,0.495,233701,0.470,8241,-0.025
FLORIDA,POLK,12,105,86009,0.408,117433,0.409,31424,0.001
FLORIDA,PUTNAM,12,107,12412,0.401,10094,0.303,-2318,-0.098
FLORIDA,SAINTJOHNS,12,109,26399,0.306,43099,0.313,16700,0.007
FLORIDA,SAINTLUCIE,12,111,51835,0.518,66881,0.471,15046,-0.047
FLORIDA,SANTAROSA,12,113,14659,0.218,18464,0.208,3805,-0.010
FLORIDA,SARASOTA,12,115,88442,0.452,97870,0.423,9428,-0.029
FLORIDA,SEMINOLE,12,117,76971,0.413,105914,0.466,28943,0.053
FLORIDA,SUMTER,12,119,11584,0.364,22638,0.293,11054,-0.071
FLORIDA,SUWANEE,12,121,4522,0.286,3964,0.211,-558,-0.075
FLORIDA,TAYLOR,12,123,3049,0.355,2152,0.230,-897,-0.125
FLORIDA,UNION,12,125,1251,0.268,1014,0.177,-237,-0.091
FLORIDA,VOLUSIA,12,127,115519,0.505,109091,0.414,-6428,-0.091
FLORIDA,WAKULLA,12,129,4896,0.416,4348,0.282,-548,-0.134
FLORIDA,WALTON,12,131,6213,0.259,6876,0.203,663,-0.056
FLORIDA,WASHINGTON,12,133,2912,0.281,2264,0.202,-648,-0.079
GEORGIA,APPLING,13,001,1848,0.290,1434,0.205,-414,-0.085
GEORGIA,ATKINSON,13,003,799,0.323,697,0.267,-102,-0.056
GEORGIA,BACON,13,005,930,0.245,608,0.151,-322,-0.094
GEORGIA,BAKER,13,007,936,0.531,650,0.451,-286,-0.080
GEORGIA,BALDWIN,13,009,6775,0.465,7970,0.495,1195,0.030
GEORGIA,BANKS,13,011,1149,0.205,684,0.098,-465,-0.107
GEORGIA,BARROW,13,013,4095,0.231,6580,0.226,2485,-0.005
GEORGIA,BARTOW,13,015,7741,0.256,8212,0.207,471,-0.049
GEORGIA,BENHILL,13,017,2180,0.394,2101,0.354,-79,-0.040
GEORGIA,BERRIEN,13,019,1638,0.293,1047,0.159,-591,-0.134
GEORGIA,BIBB,13,021,29322,0.508,36787,0.588,7465,0.080
GEORGIA,BLECKLEY,13,023,1281,0.287,1101,0.221,-180,-0.066
GEORGIA,BRANTLEY,13,025,1258,0.224,619,0.098,-639,-0.126
GEORGIA,BROOKS,13,027,2193,0.429,2528,0.399,335,-0.030
GEORGIA,BRYAN,13,029,2590,0.259,4014,0.265,1424,0.006
GEORGIA,BULLOCH,13,031,6840,0.356,9261,0.366,2421,0.010
GEORGIA,BURKE,13,033,4213,0.497,4731,0.506,518,0.009
GEORGIA,BUTTS,13,035,2572,0.333,2566,0.270,-6,-0.063
GEORGIA,CALHOUN,13,037,1119,0.554,1179,0.582,60,0.028
GEORGIA,CAMDEN,13,039,4637,0.327,5930,0.311,1293,-0.016
GEORGIA,CANDLER,13,043,1096,0.348,1026,0.273,-70,-0.075
GEORGIA,CARROLL,13,045,10224,0.289,12464,0.280,2240,-0.009
GEORGIA,CATOOSA,13,047,5807,0.260,4771,0.177,-1036,-0.083
GEORGIA,CHARLTON,13,049,1064,0.314,1004,0.250,-60,-0.064
GEORGIA,CHATHAM,13,051,45630,0.498,62290,0.551,16660,0.053
GEORGIA,CHATTAHOOCHEE,13,053,773,0.458,594,0.427,-179,-0.031
GEORGIA,CHATTOOGA,13,055,2809,0.358,1613,0.195,-1196,-0.163
GEORGIA,CHEROKEE,13,057,14824,0.201,25231,0.224,10407,0.023
GEORGIA,CLARKE,13,059,21718,0.581,29603,0.651,7885,0.070
GEORGIA,CLAY,13,061,798,0.610,697,0.548,-101,-0.062
GEORGIA,CLAYTON,13,063,56113,0.705,78220,0.836,22107,0.131
GEORGIA,CLINCH,13,065,750,0.331,686,0.279,-64,-0.052
GEORGIA,COBB,13,067,103955,0.371,160121,0.479,56166,0.108
GEORGIA,COFFEE,13,069,3979,0.323,4094,0.294,115,-0.029
GEORGIA,COLQUITT,13,071,3378,0.288,3463,0.254,85,-0.034
GEORGIA,COLUMBIA,13,073,11442,0.243,18887,0.290,7445,0.047
GEORGIA,COOK,13,075,1733,0.360,1753,0.289,20,-0.071
GEORGIA,COWETA,13,077,10647,0.250,16583,0.267,5936,0.017
GEORGIA,CRAWFORD,13,079,1552,0.352,1421,0.275,-131,-0.077
GEORGIA,CRISP,13,081,2357,0.377,2837,0.378,480,0.001
GEORGIA,DADE,13,083,1823,0.292,965,0.155,-858,-0.137
GEORGIA,DAWSON,13,085,1407,0.173,1448,0.123,41,-0.050
GEORGIA,DECATUR,13,087,3577,0.400,4124,0.401,547,0.001
GEORGIA,DEKALB,13,089,200787,0.726,251370,0.791,50583,0.065
GEORGIA,DODGE,13,091,2384,0.341,1839,0.262,-545,-0.079
GEORGIA,DOOLY,13,093,1973,0.513,1872,0.485,-101,-0.028
GEORGIA,DOUGHERTY,13,095,19805,0.588,23311,0.684,3506,0.096
GEORGIA,DOUGLAS,13,097,15997,0.380,31005,0.537,15008,0.157
GEORGIA,EARLY,13,099,1701,0.404,2168,0.453,467,0.049
GEORGIA,ECHOLS,13,101,231,0.233,156,0.132,-75,-0.101
GEORGIA,EFFINGHAM,13,103,3613,0.223,4853,0.207,1240,-0.016
GEORGIA,ELBERT,13,105,2984,0.390,2539,0.318,-445,-0.072
GEORGIA,EMANUEL,13,107,2774,0.371,2435,0.310,-339,-0.061
GEORGIA,EVANS,13,109,1213,0.345,1130,0.313,-83,-0.032
GEORGIA,FANNIN,13,111,2727,0.282,1923,0.162,-804,-0.120
GEORGIA,FAYETTE,13,113,14887,0.283,23284,0.379,8397,0.096
GEORGIA,FLOYD,13,115,10038,0.317,9159,0.263,-879,-0.054
GEORGIA,FORSYTH,13,117,9201,0.162,23462,0.237,14261,0.075
GEORGIA,FRANKLIN,13,119,2245,0.299,1243,0.145,-1002,-0.154
GEORGIA,FULTON,13,121,199436,0.593,297051,0.677,97615,0.084
GEORGIA,GILMER,13,123,2510,0.251,1965,0.154,-545,-0.097
GEORGIA,GLASCOCK,13,125,250,0.197,138,0.099,-112,-0.098
GEORGIA,GLYNN,13,127,8962,0.324,11775,0.342,2813,0.018
GEORGIA,GORDON,13,129,4028,0.255,3181,0.167,-847,-0.088
GEORGIA,GRADY,13,131,3092,0.377,3013,0.327,-79,-0.050
GEORGIA,GREENE,13,133,2774,0.404,3199,0.361,425,-0.043
GEORGIA,GWINNETT,13,135,81708,0.335,166153,0.502,84445,0.167
GEORGIA,HABERSHAM,13,137,2750,0.207,2483,0.152,-267,-0.055
GEORGIA,HALL,13,139,10514,0.211,16180,0.227,5666,0.016
GEORGIA,HANCOCK,13,141,2715,0.765,2701,0.754,-14,-0.011
GEORGIA,HARALSON,13,143,2434,0.239,1475,0.130,-959,-0.109
GEORGIA,HARRIS,13,145,3400,0.275,4086,0.248,686,-0.027
GEORGIA,HART,13,147,3479,0.385,2585,0.256,-894,-0.129
GEORGIA,HEARD,13,149,1148,0.290,743,0.176,-405,-0.114
GEORGIA,HENRY,13,151,21096,0.329,50057,0.504,28961,0.175
GEORGIA,HOUSTON,13,153,15054,0.333,22553,0.375,7499,0.042
GEORGIA,IRWIN,13,155,1051,0.308,891,0.243,-160,-0.065
GEORGIA,JACKSON,13,157,3468,0.214,4491,0.164,1023,-0.050
GEORGIA,JASPER,13,159,1558,0.329,1544,0.255,-14,-0.074
GEORGIA,JEFFDAVIS,13,161,1277,0.264,901,0.177,-376,-0.087
GEORGIA,JEFFERSON,13,163,3447,0.527,3821,0.548,374,0.021
GEORGIA,JENKINS,13,165,1494,0.439,1123,0.367,-371,-0.072
GEORGIA,JOHNSON,13,167,1263,0.355,1136,0.308,-127,-0.047
GEORGIA,JONES,13,169,3855,0.355,3961,0.316,106,-0.039
GEORGIA,LAMAR,13,171,2432,0.374,2270,0.298,-162,-0.076
GEORGIA,LANIER,13,173,931,0.360,806,0.281,-125,-0.079
GEORGIA,LAURENS,13,175,6281,0.364,6752,0.346,471,-0.018
GEORGIA,LEE,13,177,2182,0.209,3170,0.224,988,0.015
GEORGIA,LIBERTY,13,179,6619,0.517,9556,0.592,2937,0.075
GEORGIA,LINCOLN,13,181,1337,0.366,1273,0.310,-64,-0.056
GEORGIA,LONG,13,183,1033,0.340,1360,0.330,327,-0.010
GEORGIA,LOWNDES,13,185,12516,0.395,15064,0.398,2548,0.003
GEORGIA,LUMPKIN,13,187,2091,0.235,2220,0.177,129,-0.058
GEORGIA,MCDUFFIE,13,189,2899,0.373,3699,0.399,800,0.026
GEORGIA,MCINTOSH,13,191,2523,0.469,2303,0.390,-220,-0.079
GEORGIA,MACON,13,193,2906,0.608,2705,0.631,-201,0.023
GEORGIA,MADISON,13,195,2527,0.257,2425,0.201,-102,-0.056
GEORGIA,MARION,13,197,1275,0.431,1213,0.380,-62,-0.051
GEORGIA,MERIWETHER,13,199,3709,0.455,3804,0.413,95,-0.042
GEORGIA,MILLER,13,201,736,0.301,623,0.245,-113,-0.056
GEORGIA,MITCHELL,13,205,3360,0.462,3493,0.443,133,-0.019
GEORGIA,MONROE,13,207,3216,0.329,3571,0.281,355,-0.048
GEORGIA,MONTGOMERY,13,209,1007,0.318,847,0.237,-160,-0.081
GEORGIA,MORGAN,13,211,2304,0.318,2663,0.281,359,-0.037
GEORGIA,MURRAY,13,213,2899,0.271,1800,0.144,-1099,-0.127
GEORGIA,MUSCOGEE,13,215,32867,0.513,39851,0.573,6984,0.060
GEORGIA,NEWTON,13,217,10939,0.375,21943,0.496,11004,0.121
GEORGIA,OCONEE,13,219,3789,0.267,5581,0.277,1792,0.010
GEORGIA,OGLETHORPE,13,221,1899,0.337,1831,0.274,-68,-0.063
GEORGIA,PAULDING,13,223,9420,0.233,18025,0.275,8605,0.042
GEORGIA,PEACH,13,225,3961,0.463,5100,0.474,1139,0.011
GEORGIA,PICKENS,13,227,2444,0.230,1979,0.141,-465,-0.089
GEORGIA,PIERCE,13,229,1234,0.208,903,0.124,-331,-0.084
GEORGIA,PIKE,13,231,1506,0.223,1240,0.142,-266,-0.081
GEORGIA,POLK,13,233,3868,0.312,2867,0.202,-1001,-0.110
GEORGIA,PULASKI,13,235,1294,0.368,1104,0.306,-190,-0.062
GEORGIA,PUTNAM,13,237,2880,0.355,2758,0.291,-122,-0.064
GEORGIA,QUITMAN,13,239,543,0.563,461,0.442,-82,-0.121
GEORGIA,RABUN,13,241,1918,0.289,1444,0.181,-474,-0.108
GEORGIA,RANDOLPH,13,243,1612,0.529,1598,0.551,-14,0.022
GEORGIA,RICHMOND,13,245,39262,0.566,48814,0.642,9552,0.076
GEORGIA,ROCKDALE,13,247,12136,0.389,23255,0.611,11119,0.222
GEORGIA,SCHLEY,13,249,464,0.303,401,0.210,-63,-0.093
GEORGIA,SCREVEN,13,251,2534,0.428,2300,0.402,-234,-0.026
GEORGIA,SEMINOLE,13,253,1278,0.390,1189,0.331,-89,-0.059
GEORGIA,SPALDING,13,255,7460,0.355,9357,0.364,1897,0.009
GEORGIA,STEPHENS,13,257,2714,0.281,1837,0.187,-877,-0.094
GEORGIA,STEWART,13,259,1220,0.601,1222,0.594,2,-0.007
GEORGIA,SUMTER,13,261,5562,0.493,5520,0.503,-42,0.010
GEORGIA,TALBOT,13,263,1830,0.621,2002,0.617,172,-0.004
GEORGIA,TALIAFERRO,13,265,612,0.644,545,0.608,-67,-0.036
GEORGIA,TATTNALL,13,267,1787,0.276,1681,0.244,-106,-0.032
GEORGIA,TAYLOR,13,269,1458,0.431,1296,0.380,-162,-0.051
GEORGIA,TELFAIR,13,271,1590,0.421,1313,0.346,-277,-0.075
GEORGIA,TERRELL,13,273,1951,0.510,2267,0.541,316,0.031
GEORGIA,THOMAS,13,275,5997,0.382,7142,0.380,1145,-0.002
GEORGIA,TIFT,13,277,3864,0.308,4347,0.306,483,-0.002
GEORGIA,TOOMBS,13,279,2567,0.291,2338,0.256,-229,-0.035
GEORGIA,TOWNS,13,281,1430,0.271,1210,0.179,-220,-0.092
GEORGIA,TREUTLEN,13,283,1052,0.381,862,0.319,-190,-0.062
GEORGIA,TROUP,13,285,7630,0.348,9713,0.372,2083,0.024
GEORGIA,TURNER,13,287,1135,0.383,1246,0.367,111,-0.016
GEORGIA,TWIGGS,13,289,2220,0.509,1971,0.486,-249,-0.023
GEORGIA,UNION,13,291,2327,0.252,1963,0.163,-364,-0.089
GEORGIA,UPSON,13,293,3424,0.339,3475,0.318,51,-0.021
GEORGIA,WALKER,13,295,5986,0.279,4215,0.176,-1771,-0.103
GEORGIA,WALTON,13,297,5887,0.213,8292,0.204,2405,-0.009
GEORGIA,WARE,13,299,3449,0.306,3440,0.282,-9,-0.024
GEORGIA,WARREN,13,301,1360,0.546,1314,0.563,-46,0.017
GEORGIA,WASHINGTON,13,303,3733,0.476,4200,0.496,467,0.020
GEORGIA,WAYNE,13,305,2683,0.281,2041,0.196,-642,-0.085
GEORGIA,WEBSTER,13,307,515,0.511,473,0.424,-42,-0.087
GEORGIA,WHEELER,13,309,847,0.413,646,0.307,-201,-0.106
GEORGIA,WHITE,13,311,2016,0.212,1674,0.141,-342,-0.071
GEORGIA,WHITFIELD,13,313,6933,0.263,7937,0.259,1004,-0.004
GEORGIA,WILCOX,13,315,902,0.344,852,0.286,-50,-0.058
GEORGIA,WILKES,13,317,2028,0.446,1848,0.412,-180,-0.034
GEORGIA,WILKINSON,13,319,2235,0.495,1894,0.442,-341,-0.053
GEORGIA,WORTH,13,321,2219,0.302,2020,0.244,-199,-0.058
HAWAII,OVERSEAS,ERROR,ERROR,373,0.814,637,0.875,264,0.061
HAWAII,HAWAII,15,001,35116,0.609,41259,0.636,6143,0.027
HAWAII,MAUI,15,009,28803,0.607,33480,0.645,4677,0.038
HAWAII,KAUAI,15,007,14916,0.600,16456,0.625,1540,0.025
HAWAII,HONOLULU,15,003,152500,0.511,175696,0.615,23196,0.104
IDAHO,ADA,16,001,58523,0.377,75677,0.387,17154,0.010
IDAHO,ADAMS,16,003,555,0.269,415,0.190,-140,-0.079
IDAHO,BANNOCK,16,005,12903,0.370,10342,0.309,-2561,-0.061
IDAHO,BEARLAKE,16,007,494,0.163,255,0.087,-239,-0.076
IDAHO,BENEWAH,16,009,1148,0.283,770,0.184,-378,-0.099
IDAHO,BINGHAM,16,011,3605,0.218,2924,0.176,-681,-0.042
IDAHO,BLAINE,16,013,5992,0.591,6416,0.598,424,0.007
IDAHO,BOISE,16,015,970,0.275,777,0.204,-193,-0.071
IDAHO,BONNER,16,017,6649,0.376,5819,0.278,-830,-0.098
IDAHO,BONNEVILLE,16,019,8356,0.215,8930,0.202,574,-0.013
IDAHO,BOUNDARY,16,021,1268,0.290,933,0.181,-335,-0.109
IDAHO,BUTTE,16,023,321,0.228,160,0.130,-161,-0.098
IDAHO,CAMAS,16,025,139,0.234,110,0.186,-29,-0.048
IDAHO,CANYON,16,027,13415,0.241,16883,0.232,3468,-0.009
IDAHO,CARIBOU,16,029,491,0.150,271,0.089,-220,-0.061
IDAHO,CASSIA,16,031,1153,0.147,1036,0.127,-117,-0.020
IDAHO,CLARK,16,033,46,0.130,44,0.155,-2,0.025
IDAHO,CLEARWATER,16,035,1117,0.277,704,0.185,-413,-0.092
IDAHO,CUSTER,16,037,559,0.237,427,0.177,-132,-0.060
IDAHO,ELMORE,16,039,1959,0.243,1814,0.213,-145,-0.030
IDAHO,FRANKLIN,16,041,456,0.090,385,0.070,-71,-0.020
IDAHO,FREMONT,16,043,741,0.128,651,0.114,-90,-0.014
IDAHO,GEM,16,045,1628,0.228,1229,0.155,-399,-0.073
IDAHO,GOODING,16,047,1278,0.240,930,0.179,-348,-0.061
IDAHO,IDAHO,16,049,1689,0.212,1196,0.145,-493,-0.067
IDAHO,JEFFERSON,16,051,1084,0.122,976,0.085,-108,-0.037
IDAHO,JEROME,16,053,1344,0.204,1329,0.197,-15,-0.007
IDAHO,KOOTENAI,16,055,17584,0.322,16264,0.245,-1320,-0.077
IDAHO,LATAH,16,057,8430,0.480,8093,0.445,-337,-0.035
IDAHO,LEMHI,16,059,915,0.226,733,0.179,-182,-0.047
IDAHO,LEWIS,16,061,440,0.242,270,0.170,-170,-0.072
IDAHO,LINCOLN,16,063,466,0.248,360,0.206,-106,-0.042
IDAHO,MADISON,16,065,826,0.071,1201,0.077,375,0.006
IDAHO,MINIDOKA,16,067,1331,0.185,1167,0.170,-164,-0.015
IDAHO,NEZPERCE,16,069,6476,0.366,4828,0.281,-1648,-0.085
IDAHO,ONEIDA,16,071,304,0.143,184,0.089,-120,-0.054
IDAHO,OWYHEE,16,073,685,0.191,591,0.151,-94,-0.040
IDAHO,PAYETTE,16,075,1848,0.226,1507,0.173,-341,-0.053
IDAHO,POWER,16,077,829,0.280,699,0.253,-130,-0.027
IDAHO,SHOSHONE,16,079,2331,0.437,1384,0.270,-947,-0.167
IDAHO,TETON,16,081,1416,0.384,2159,0.434,743,0.050
IDAHO,TWINFALLS,16,083,6458,0.244,6233,0.209,-225,-0.035
IDAHO,VALLEY,16,085,1843,0.386,1913,0.358,70,-0.028
IDAHO,WASHINGTON,16,087,1033,0.237,776,0.174,-257,-0.063
ILLINOIS,ADAMS,17,001,10511,0.334,7676,0.238,-2835,-0.096
ILLINOIS,ALEXANDER,17,003,2016,0.521,1262,0.448,-754,-0.073
ILLINOIS,BOND,17,005,3228,0.438,2068,0.275,-1160,-0.163
ILLINOIS,BOONE,17,007,8286,0.424,8986,0.391,700,-0.033
ILLINOIS,BROWN,17,009,895,0.346,476,0.200,-419,-0.146
ILLINOIS,BUREAU,17,011,7961,0.445,6029,0.364,-1932,-0.081
ILLINOIS,CALHOUN,17,013,1367,0.505,739,0.287,-628,-0.218
ILLINOIS,CARROLL,17,015,3537,0.435,2447,0.329,-1090,-0.106
ILLINOIS,CASS,17,017,2492,0.437,1621,0.316,-871,-0.121
ILLINOIS,CHAMPAIGN,17,019,41524,0.504,50137,0.547,8613,0.043
ILLINOIS,CHRISTIAN,17,021,6112,0.400,3992,0.260,-2120,-0.140
ILLINOIS,CLARK,17,023,2877,0.359,1877,0.237,-1000,-0.122
ILLINOIS,CLAY,17,025,2101,0.321,1020,0.161,-1081,-0.160
ILLINOIS,CLINTON,17,027,6797,0.397,3945,0.226,-2852,-0.171
ILLINOIS,COLES,17,029,9566,0.420,7309,0.337,-2257,-0.083
ILLINOIS,COOK,17,031,1439724,0.702,1611946,0.743,172222,0.041
ILLINOIS,CRAWFORD,17,033,3194,0.342,1992,0.228,-1202,-0.114
ILLINOIS,CUMBERLAND,17,035,1862,0.344,1031,0.185,-831,-0.159
ILLINOIS,DEKALB,17,037,19263,0.473,20466,0.469,1203,-0.004
ILLINOIS,DEWITT,17,039,2836,0.364,1910,0.255,-926,-0.109
ILLINOIS,DOUGLAS,17,041,2767,0.324,1949,0.238,-818,-0.086
ILLINOIS,DUPAGE,17,043,180097,0.448,228622,0.533,48525,0.085
ILLINOIS,EDGAR,17,045,3093,0.367,1793,0.229,-1300,-0.138
ILLINOIS,EDWARDS,17,047,930,0.276,434,0.131,-496,-0.145
ILLINOIS,EFFINGHAM,17,049,4388,0.270,3083,0.176,-1305,-0.094
ILLINOIS,FAYETTE,17,051,3571,0.374,1819,0.190,-1752,-0.184
ILLINOIS,FORD,17,053,1912,0.295,1414,0.221,-498,-0.074
ILLINOIS,FRANKLIN,17,055,8816,0.456,4727,0.253,-4089,-0.203
ILLINOIS,FULTON,17,057,9080,0.533,6133,0.392,-2947,-0.141
ILLINOIS,GALLATIN,17,059,1573,0.488,657,0.243,-916,-0.245
ILLINOIS,GREENE,17,061,2457,0.405,1205,0.216,-1252,-0.189
ILLINOIS,GRUNDY,17,063,8463,0.427,8065,0.347,-398,-0.080
ILLINOIS,HAMILTON,17,065,1814,0.402,802,0.193,-1012,-0.209
ILLINOIS,HANCOCK,17,067,3975,0.402,2139,0.236,-1836,-0.166
ILLINOIS,HARDIN,17,069,923,0.379,420,0.196,-503,-0.183
ILLINOIS,HENDERSON,17,071,2269,0.546,1155,0.331,-1114,-0.215
ILLINOIS,HENRY,17,073,11877,0.471,8871,0.364,-3006,-0.107
ILLINOIS,IROQUOIS,17,075,3832,0.277,2504,0.191,-1328,-0.086
ILLINOIS,JACKSON,17,077,14300,0.554,11634,0.473,-2666,-0.081
ILLINOIS,JASPER,17,079,1781,0.334,924,0.181,-857,-0.153
ILLINOIS,JEFFERSON,17,081,6713,0.396,4425,0.260,-2288,-0.136
ILLINOIS,JERSEY,17,083,4597,0.453,2679,0.244,-1918,-0.209
ILLINOIS,JODAVIESS,17,085,5311,0.458,4462,0.398,-849,-0.060
ILLINOIS,JOHNSON,17,087,1813,0.309,1142,0.188,-671,-0.121
ILLINOIS,KANE,17,089,75922,0.442,103665,0.520,27743,0.078
ILLINOIS,KANKAKEE,17,091,20003,0.444,18971,0.401,-1032,-0.043
ILLINOIS,KENDALL,17,093,12374,0.382,24884,0.461,12510,0.079
ILLINOIS,KNOX,17,095,13403,0.542,10083,0.448,-3320,-0.094
ILLINOIS,LAKE,17,097,134352,0.488,171095,0.572,36743,0.084
ILLINOIS,LASALLE,17,099,24263,0.478,19543,0.393,-4720,-0.085
ILLINOIS,LAWRENCE,17,101,2518,0.374,1290,0.213,-1228,-0.161
ILLINOIS,LEE,17,103,6416,0.404,5528,0.357,-888,-0.047
ILLINOIS,LIVINGSTON,17,105,5632,0.351,4023,0.265,-1609,-0.086
ILLINOIS,LOGAN,17,107,4273,0.317,3313,0.267,-960,-0.050
ILLINOIS,MCDONOUGH,17,109,7119,0.477,5288,0.402,-1831,-0.075
ILLINOIS,MCHENRY,17,111,50330,0.393,60803,0.422,10473,0.029
ILLINOIS,MCLEAN,17,113,29877,0.417,36196,0.445,6319,0.028
ILLINOIS,MACON,17,115,23341,0.451,18343,0.382,-4998,-0.069
ILLINOIS,MACOUPIN,17,117,11193,0.491,6689,0.299,-4504,-0.192
ILLINOIS,MADISON,17,119,63399,0.513,50587,0.393,-12812,-0.120
ILLINOIS,MARION,17,121,7694,0.447,4369,0.256,-3325,-0.191
ILLINOIS,MARSHALL,17,123,2806,0.426,1789,0.299,-1017,-0.127
ILLINOIS,MASON,17,125,3215,0.448,2014,0.312,-1201,-0.136
ILLINOIS,MASSAC,17,127,2805,0.378,1558,0.234,-1247,-0.144
ILLINOIS,MENARD,17,129,2137,0.325,1817,0.279,-320,-0.046
ILLINOIS,MERCER,17,131,4512,0.503,3071,0.360,-1441,-0.143
ILLINOIS,MONROE,17,133,6788,0.415,5535,0.286,-1253,-0.129
ILLINOIS,MONTGOMERY,17,135,5979,0.462,3504,0.270,-2475,-0.192
ILLINOIS,MORGAN,17,137,5650,0.372,4696,0.317,-954,-0.055
ILLINOIS,MOULTRIE,17,139,2388,0.369,1481,0.236,-907,-0.133
ILLINOIS,OGLE,17,141,9018,0.374,8050,0.333,-968,-0.041
ILLINOIS,PEORIA,17,143,41121,0.497,38060,0.481,-3061,-0.016
ILLINOIS,PERRY,17,145,4770,0.458,2462,0.250,-2308,-0.208
ILLINOIS,PIATT,17,147,3124,0.364,2645,0.292,-479,-0.072
ILLINOIS,PIKE,17,149,2849,0.357,1413,0.188,-1436,-0.169
ILLINOIS,POPE,17,151,918,0.377,375,0.176,-543,-0.201
ILLINOIS,PULASKI,17,153,1372,0.441,962,0.355,-410,-0.086
ILLINOIS,PUTNAM,17,155,1704,0.508,1147,0.372,-557,-0.136
ILLINOIS,RANDOLPH,17,157,6771,0.453,3439,0.242,-3332,-0.211
ILLINOIS,RICHLAND,17,159,2529,0.326,1584,0.207,-945,-0.119
ILLINOIS,ROCKISLAND,17,161,39880,0.570,32298,0.511,-7582,-0.059
ILLINOIS,STCLAIR,17,163,62410,0.551,60756,0.499,-1654,-0.052
ILLINOIS,SALINE,17,165,4697,0.398,2572,0.228,-2125,-0.170
ILLINOIS,SANGAMON,17,167,38630,0.405,40907,0.416,2277,0.011
ILLINOIS,SCHUYLER,17,169,1594,0.395,1075,0.281,-519,-0.114
ILLINOIS,SCOTT,17,171,927,0.352,535,0.205,-392,-0.147
ILLINOIS,SHELBY,17,173,3744,0.354,2288,0.208,-1456,-0.146
ILLINOIS,STARK,17,175,1189,0.388,751,0.276,-438,-0.112
ILLINOIS,STEPHENSON,17,177,8913,0.418,7768,0.382,-1145,-0.036
ILLINOIS,TAZEWELL,17,179,25814,0.414,20685,0.324,-5129,-0.090
ILLINOIS,UNION,17,181,3735,0.410,2402,0.279,-1333,-0.131
ILLINOIS,VERMILION,17,183,14726,0.437,10039,0.328,-4687,-0.109
ILLINOIS,WABASH,17,185,1752,0.292,1151,0.212,-601,-0.080
ILLINOIS,WARREN,17,187,3938,0.466,2987,0.383,-951,-0.083
ILLINOIS,WASHINGTON,17,189,2986,0.368,1448,0.195,-1538,-0.173
ILLINOIS,WAYNE,17,191,2139,0.258,1048,0.126,-1091,-0.132
ILLINOIS,WHITE,17,193,3071,0.370,1412,0.193,-1659,-0.177
ILLINOIS,WHITESIDE,17,195,13723,0.511,11035,0.431,-2688,-0.080
ILLINOIS,WILL,17,197,115625,0.469,151927,0.499,36302,0.030
ILLINOIS,WILLIAMSON,17,199,11685,0.390,8581,0.271,-3104,-0.119
ILLINOIS,WINNEBAGO,17,201,59740,0.492,55713,0.464,-4027,-0.028
ILLINOIS,WOODFORD,17,203,6005,0.319,5092,0.256,-913,-0.063
INDIANA,ADAMS,18,001,3512,0.263,2805,0.213,-707,-0.050
INDIANA,ALLEN,18,003,46710,0.360,55382,0.373,8672,0.013
INDIANA,BARTHOLOMEW,18,005,9191,0.322,9841,0.301,650,-0.021
INDIANA,BENTON,18,007,1135,0.284,860,0.233,-275,-0.051
INDIANA,BLACKFORD,18,009,1903,0.354,1243,0.257,-660,-0.097
INDIANA,BOONE,18,011,5636,0.246,10181,0.313,4545,0.067
INDIANA,BROWN,18,013,2730,0.372,2518,0.317,-212,-0.055
INDIANA,CARROLL,18,015,2689,0.311,1892,0.219,-797,-0.092
INDIANA,CASS,18,017,4315,0.310,3759,0.265,-556,-0.045
INDIANA,CLARK,18,019,17648,0.417,18808,0.363,1160,-0.054
INDIANA,CLAY,18,021,3333,0.309,2306,0.203,-1027,-0.106
INDIANA,CLINTON,18,023,3335,0.281,2819,0.236,-516,-0.045
INDIANA,CRAWFORD,18,025,1932,0.422,1323,0.288,-609,-0.134
INDIANA,DAVIESS,18,027,2573,0.243,1800,0.166,-773,-0.077
INDIANA,DEARBORN,18,029,6596,0.315,4883,0.204,-1713,-0.111
INDIANA,DECATUR,18,031,2621,0.257,2121,0.190,-500,-0.067
INDIANA,DEKALB,18,033,4810,0.312,3942,0.233,-868,-0.079
INDIANA,DELAWARE,18,035,20436,0.426,18153,0.399,-2283,-0.027
INDIANA,DUBOIS,18,037,5210,0.305,5389,0.268,179,-0.037
INDIANA,ELKHART,18,039,17966,0.293,20740,0.313,2774,0.020
INDIANA,FAYETTE,18,041,3626,0.383,2252,0.236,-1374,-0.147
INDIANA,FLOYD,18,043,13857,0.409,13945,0.369,88,-0.040
INDIANA,FOUNTAIN,18,045,2477,0.317,1476,0.196,-1001,-0.121
INDIANA,FRANKLIN,18,047,2925,0.293,1969,0.179,-956,-0.114
INDIANA,FULTON,18,049,2607,0.300,1960,0.232,-647,-0.068
INDIANA,GIBSON,18,051,5378,0.368,3721,0.240,-1657,-0.128
INDIANA,GRANT,18,053,8509,0.310,7010,0.274,-1499,-0.036
INDIANA,GREENE,18,055,4606,0.345,2929,0.211,-1677,-0.134
INDIANA,HAMILTON,18,057,26388,0.252,57263,0.367,30875,0.115
INDIANA,HANCOCK,18,059,6912,0.248,8904,0.244,1992,-0.004
INDIANA,HARRISON,18,061,6171,0.356,4783,0.258,-1388,-0.098
INDIANA,HENDRICKS,18,063,13548,0.259,22600,0.297,9052,0.038
INDIANA,HENRY,18,065,7176,0.350,5124,0.254,-2052,-0.096
INDIANA,HOWARD,18,067,12998,0.351,11215,0.300,-1783,-0.051
INDIANA,HUNTINGTON,18,069,3877,0.248,3506,0.217,-371,-0.031
INDIANA,JACKSON,18,071,5092,0.312,3843,0.218,-1249,-0.094
INDIANA,JASPER,18,073,3678,0.311,3329,0.249,-349,-0.062
INDIANA,JAY,18,075,2740,0.333,1889,0.237,-851,-0.096
INDIANA,JEFFERSON,18,077,5117,0.394,4326,0.317,-791,-0.077
INDIANA,JENNINGS,18,079,3538,0.336,2364,0.212,-1174,-0.124
INDIANA,JOHNSON,18,081,13109,0.256,17318,0.258,4209,0.002
INDIANA,KNOX,18,083,5649,0.359,3772,0.243,-1877,-0.116
INDIANA,KOSCIUSKO,18,085,5977,0.211,6313,0.195,336,-0.016
INDIANA,LAGRANGE,18,087,2523,0.280,2080,0.217,-443,-0.063
INDIANA,LAKE,18,089,114743,0.610,116935,0.577,2192,-0.033
INDIANA,LAPORTE,18,091,21114,0.496,19798,0.434,-1316,-0.062
INDIANA,LAWRENCE,18,093,5346,0.302,4210,0.220,-1136,-0.082
INDIANA,MADISON,18,095,21882,0.399,18595,0.342,-3287,-0.057
INDIANA,MARION,18,097,162249,0.506,212899,0.580,50650,0.074
INDIANA,MARSHALL,18,099,5593,0.314,4798,0.263,-795,-0.051
INDIANA,MARTIN,18,101,1522,0.305,881,0.183,-641,-0.122
INDIANA,MIAMI,18,103,3886,0.285,2766,0.205,-1120,-0.080
INDIANA,MONROE,18,105,26965,0.534,34216,0.585,7251,0.051
INDIANA,MONTGOMERY,18,107,3536,0.243,3362,0.222,-174,-0.021
INDIANA,MORGAN,18,109,6650,0.255,6040,0.192,-610,-0.063
INDIANA,NEWTON,18,111,2032,0.347,1404,0.242,-628,-0.105
INDIANA,NOBLE,18,113,4703,0.300,3904,0.228,-799,-0.072
INDIANA,OHIO,18,115,1139,0.385,686,0.235,-453,-0.150
INDIANA,ORANGE,18,117,2885,0.333,2048,0.250,-837,-0.083
INDIANA,OWEN,18,119,2536,0.334,1946,0.227,-590,-0.107
INDIANA,PARKE,18,121,2362,0.339,1441,0.217,-921,-0.122
INDIANA,PERRY,18,123,4131,0.497,3062,0.380,-1069,-0.117
INDIANA,PIKE,18,125,2418,0.389,1297,0.217,-1121,-0.172
INDIANA,PORTER,18,127,29388,0.453,33676,0.430,4288,-0.023
INDIANA,POSEY,18,129,4085,0.341,3521,0.282,-564,-0.059
INDIANA,PULASKI,18,131,1750,0.312,1327,0.243,-423,-0.069
INDIANA,PUTNAM,18,133,4103,0.312,3356,0.228,-747,-0.084
INDIANA,RANDOLPH,18,135,3812,0.344,2446,0.232,-1366,-0.112
INDIANA,RIPLEY,18,137,3510,0.297,2471,0.191,-1039,-0.106
INDIANA,RUSH,18,139,2000,0.270,1525,0.211,-475,-0.059
INDIANA,SAINTJOSEPH,18,141,52637,0.485,52252,0.467,-385,-0.018
INDIANA,SCOTT,18,143,3822,0.440,2642,0.290,-1180,-0.150
INDIANA,SHELBY,18,145,4519,0.282,4247,0.236,-272,-0.046
INDIANA,SPENCER,18,147,3920,0.395,2861,0.287,-1059,-0.108
INDIANA,STARKE,18,149,3987,0.446,2489,0.267,-1498,-0.179
INDIANA,STEUBEN,18,151,4345,0.337,3744,0.257,-601,-0.080
INDIANA,SULLIVAN,18,153,3341,0.398,2113,0.247,-1228,-0.151
INDIANA,SWITZERLAND,18,155,1479,0.403,930,0.251,-549,-0.152
INDIANA,TIPPECANOE,18,157,20818,0.398,27282,0.431,6464,0.033
INDIANA,TIPTON,18,159,2203,0.279,1587,0.211,-616,-0.068
INDIANA,UNION,18,161,1045,0.313,715,0.217,-330,-0.096
INDIANA,VANDERBURGH,18,163,28767,0.407,28530,0.389,-237,-0.018
INDIANA,VERMILLION,18,165,3424,0.488,2081,0.298,-1343,-0.190
INDIANA,VIGO,18,167,18426,0.464,15931,0.397,-2495,-0.067
INDIANA,WABASH,18,169,3920,0.288,3018,0.223,-902,-0.065
INDIANA,WARREN,18,171,1356,0.342,839,0.213,-517,-0.129
INDIANA,WARRICK,18,173,8980,0.345,9086,0.303,106,-0.042
INDIANA,WASHINGTON,18,175,3879,0.357,2636,0.232,-1243,-0.125
INDIANA,WAYNE,18,177,10775,0.390,8322,0.325,-2453,-0.065
INDIANA,WELLS,18,179,3112,0.252,2586,0.195,-526,-0.057
INDIANA,WHITE,18,181,3277,0.316,2590,0.257,-687,-0.059
INDIANA,WHITLEY,18,183,3880,0.288,3379,0.214,-501,-0.074
IOWA,ADAIR,19,001,1844,0.431,1133,0.297,-711,-0.134
IOWA,ADAMS,19,003,977,0.420,565,0.268,-412,-0.152
IOWA,ALLAMAKEE,19,005,3449,0.488,2421,0.350,-1028,-0.138
IOWA,APPANOOSE,19,007,3063,0.475,1814,0.296,-1249,-0.179
IOWA,AUDUBON,19,009,1608,0.448,1080,0.317,-528,-0.131
IOWA,BENTON,19,011,6747,0.500,4678,0.338,-2069,-0.162
IOWA,BLACKHAWK,19,013,35392,0.554,32233,0.500,-3159,-0.054
IOWA,BOONE,19,015,7027,0.502,5541,0.390,-1486,-0.112
IOWA,BREMER,19,017,6025,0.471,5356,0.396,-669,-0.075
IOWA,BUCHANAN,19,019,5608,0.535,3970,0.387,-1638,-0.148
IOWA,BUENAVISTA,19,021,3520,0.415,2856,0.345,-664,-0.070
IOWA,BUTLER,19,023,3001,0.401,2157,0.287,-844,-0.114
IOWA,CALHOUN,19,025,2243,0.405,1398,0.271,-845,-0.134
IOWA,CARROLL,19,027,4689,0.446,3309,0.314,-1380,-0.132
IOWA,CASS,19,029,2679,0.355,1951,0.274,-728,-0.081
IOWA,CEDAR,19,031,4747,0.490,3599,0.377,-1148,-0.113
IOWA,CERROGORDO,19,033,13372,0.545,9862,0.429,-3510,-0.116
IOWA,CHEROKEE,19,035,2988,0.440,1679,0.268,-1309,-0.172
IOWA,CHICKASAW,19,037,3708,0.545,2266,0.352,-1442,-0.193
IOWA,CLARKE,19,039,2323,0.509,1465,0.329,-858,-0.180
IOWA,CLAY,19,041,3547,0.413,2249,0.261,-1298,-0.152
IOWA,CLAYTON,19,043,4736,0.517,3237,0.355,-1499,-0.162
IOWA,CLINTON,19,045,13813,0.560,10095,0.438,-3718,-0.122
IOWA,CRAWFORD,19,047,3220,0.445,1991,0.287,-1229,-0.158
IOWA,DALLAS,19,049,10917,0.415,15701,0.410,4784,-0.005
IOWA,DAVIS,19,051,1731,0.442,977,0.252,-754,-0.190
IOWA,DECATUR,19,053,1859,0.463,1201,0.322,-658,-0.141
IOWA,DELAWARE,19,055,4227,0.459,2957,0.320,-1270,-0.139
IOWA,DESMOINES,19,057,12456,0.597,8212,0.430,-4244,-0.167
IOWA,DICKINSON,19,059,4140,0.433,3056,0.295,-1084,-0.138
IOWA,DUBUQUE,19,061,26561,0.565,22850,0.460,-3711,-0.105
IOWA,EMMET,19,063,2405,0.466,1357,0.286,-1048,-0.180
IOWA,FAYETTE,19,065,5185,0.499,3689,0.370,-1496,-0.129
IOWA,FLOYD,19,067,4349,0.533,3179,0.394,-1170,-0.139
IOWA,FRANKLIN,19,069,2340,0.424,1493,0.301,-847,-0.123
IOWA,FREMONT,19,071,1510,0.386,963,0.268,-547,-0.118
IOWA,GREENE,19,073,2459,0.481,1691,0.351,-768,-0.130
IOWA,GRUNDY,19,075,2386,0.348,1856,0.270,-530,-0.078
IOWA,GUTHRIE,19,077,2614,0.436,1732,0.301,-882,-0.135
IOWA,HAMILTON,19,079,3895,0.467,2726,0.354,-1169,-0.113
IOWA,HANCOCK,19,081,2484,0.421,1587,0.270,-897,-0.151
IOWA,HARDIN,19,083,4015,0.449,2787,0.327,-1228,-0.122
IOWA,HARRISON,19,085,2906,0.378,2131,0.285,-775,-0.093
IOWA,HENRY,19,087,4127,0.436,2904,0.309,-1223,-0.127
IOWA,HOWARD,19,089,2614,0.557,1677,0.368,-937,-0.189
IOWA,HUMBOLDT,19,091,2146,0.401,1252,0.246,-894,-0.155
IOWA,IDA,19,093,1415,0.375,792,0.219,-623,-0.156
IOWA,IOWA,19,095,3841,0.454,3084,0.346,-757,-0.108
IOWA,JACKSON,19,097,5656,0.565,3837,0.372,-1819,-0.193
IOWA,JASPER,19,099,10430,0.520,7109,0.373,-3321,-0.147
IOWA,JEFFERSON,19,101,4490,0.542,3710,0.455,-780,-0.087
IOWA,JOHNSON,19,103,41847,0.640,50200,0.652,8353,0.012
IOWA,JONES,19,105,5054,0.507,3787,0.374,-1267,-0.133
IOWA,KEOKUK,19,107,2294,0.419,1342,0.269,-952,-0.150
IOWA,KOSSUTH,19,109,4132,0.446,2543,0.295,-1589,-0.151
IOWA,LEE,19,111,10152,0.568,6215,0.385,-3937,-0.183
IOWA,LINN,19,113,60442,0.546,58935,0.503,-1507,-0.043
IOWA,LOUISA,19,115,2297,0.467,1648,0.329,-649,-0.138
IOWA,LUCAS,19,117,1987,0.435,1239,0.285,-748,-0.150
IOWA,LYON,19,119,1303,0.214,920,0.144,-383,-0.070
IOWA,MADISON,19,121,3380,0.422,2678,0.310,-702,-0.112
IOWA,MAHASKA,19,123,3790,0.353,2619,0.246,-1171,-0.107
IOWA,MARION,19,125,6574,0.394,5482,0.308,-1092,-0.086
IOWA,MARSHALL,19,127,9443,0.493,7652,0.426,-1791,-0.067
IOWA,MILLS,19,129,2308,0.333,2090,0.271,-218,-0.062
IOWA,MITCHELL,19,131,2785,0.508,1888,0.349,-897,-0.159
IOWA,MONONA,19,133,2397,0.478,1247,0.273,-1150,-0.205
IOWA,MONROE,19,135,1855,0.468,1056,0.273,-799,-0.195
IOWA,MONTGOMERY,19,137,1899,0.342,1314,0.261,-585,-0.081
IOWA,MUSCATINE,19,139,9542,0.510,8368,0.431,-1174,-0.079
IOWA,OBRIEN,19,141,2330,0.301,1315,0.178,-1015,-0.123
IOWA,OSCEOLA,19,143,934,0.286,552,0.172,-382,-0.114
IOWA,PAGE,19,145,2211,0.294,1807,0.257,-404,-0.037
IOWA,PALOALTO,19,147,2482,0.478,1398,0.297,-1084,-0.181
IOWA,PLYMOUTH,19,149,4278,0.350,2885,0.219,-1393,-0.131
IOWA,POCAHONTAS,19,151,1822,0.422,963,0.249,-859,-0.173
IOWA,POLK,19,153,95828,0.473,119804,0.517,23976,0.044
IOWA,POTTAWATTAMIE,19,155,16906,0.404,15355,0.360,-1551,-0.044
IOWA,POWESHIEK,19,157,5043,0.500,4304,0.438,-739,-0.062
IOWA,RINGGOLD,19,159,1286,0.463,753,0.278,-533,-0.185
IOWA,SAC,19,161,2215,0.412,1270,0.244,-945,-0.168
IOWA,SCOTT,19,163,42122,0.509,40440,0.469,-1682,-0.040
IOWA,SHELBY,19,165,2355,0.353,1662,0.261,-693,-0.092
IOWA,SIOUX,19,167,2259,0.136,2300,0.126,41,-0.010
IOWA,STORY,19,169,23296,0.522,25709,0.507,2413,-0.015
IOWA,TAMA,19,171,4487,0.499,3196,0.365,-1291,-0.134
IOWA,TAYLOR,19,173,1252,0.392,758,0.250,-494,-0.142
IOWA,UNION,19,175,2747,0.460,1922,0.330,-825,-0.130
IOWA,VANBUREN,19,177,1568,0.409,845,0.237,-723,-0.172
IOWA,WAPELLO,19,179,9125,0.546,5594,0.369,-3531,-0.177
IOWA,WARREN,19,181,10730,0.465,10411,0.381,-319,-0.084
IOWA,WASHINGTON,19,183,4595,0.430,3943,0.361,-652,-0.069
IOWA,WAYNE,19,185,1379,0.440,719,0.245,-660,-0.195
IOWA,WEBSTER,19,187,9561,0.513,6305,0.362,-3256,-0.151
IOWA,WINNEBAGO,19,189,2707,0.455,1931,0.334,-776,-0.121
IOWA,WINNESHIEK,19,191,5354,0.496,5254,0.462,-100,-0.034
IOWA,WOODBURY,19,193,21455,0.485,16210,0.371,-5245,-0.114
IOWA,WORTH,19,195,2286,0.554,1530,0.359,-756,-0.195
IOWA,WRIGHT,19,197,2930,0.444,1896,0.315,-1034,-0.129
KANSAS,ALLEN,20,001,1885,0.326,1398,0.263,-487,-0.063
KANSAS,ANDERSON,20,003,1291,0.336,665,0.203,-626,-0.133
KANSAS,ATCHISON,20,005,3028,0.438,1946,0.304,-1082,-0.134
KANSAS,BARBER,20,007,585,0.247,281,0.127,-304,-0.120
KANSAS,BARTON,20,009,2837,0.246,1823,0.179,-1014,-0.067
KANSAS,BOURBON,20,011,2167,0.332,1306,0.221,-861,-0.111
KANSAS,BROWN,20,013,1234,0.285,850,0.215,-384,-0.070
KANSAS,BUTLER,20,015,6292,0.275,6573,0.239,281,-0.036
KANSAS,CHASE,20,017,413,0.278,313,0.233,-100,-0.045
KANSAS,CHAUTAUQUA,20,019,400,0.208,236,0.128,-164,-0.080
KANSAS,CHEROKEE,20,021,3694,0.375,1959,0.234,-1735,-0.141
KANSAS,CHEYENNE,20,023,317,0.189,188,0.133,-129,-0.055
KANSAS,CLARK,20,025,254,0.200,118,0.120,-136,-0.080
KANSAS,CLAY,20,027,777,0.197,665,0.178,-112,-0.019
KANSAS,CLOUD,20,029,1179,0.269,744,0.194,-435,-0.075
KANSAS,COFFEY,20,031,1076,0.248,719,0.181,-357,-0.067
KANSAS,COMANCHE,20,033,198,0.203,102,0.119,-96,-0.084
KANSAS,COWLEY,20,035,4747,0.334,3436,0.282,-1311,-0.052
KANSAS,CRAWFORD,20,037,7470,0.462,5064,0.352,-2406,-0.110
KANSAS,DECATUR,20,039,355,0.204,178,0.122,-177,-0.082
KANSAS,DICKINSON,20,041,2316,0.268,1582,0.198,-734,-0.070
KANSAS,DONIPHAN,20,043,1049,0.295,584,0.173,-465,-0.122
KANSAS,DOUGLAS,20,045,27282,0.567,31195,0.626,3913,0.059
KANSAS,EDWARDS,20,047,383,0.259,208,0.159,-175,-0.100
KANSAS,ELK,20,049,367,0.243,160,0.127,-207,-0.116
KANSAS,ELLIS,20,051,3938,0.332,2669,0.229,-1269,-0.103
KANSAS,ELLSWORTH,20,053,794,0.258,515,0.196,-279,-0.062
KANSAS,FINNEY,20,055,2303,0.236,3006,0.309,703,0.073
KANSAS,FORD,20,057,2195,0.252,2032,0.274,-163,0.022
KANSAS,FRANKLIN,20,059,3874,0.343,2829,0.265,-1045,-0.078
KANSAS,GEARY,20,061,2436,0.344,2569,0.360,133,0.016
KANSAS,GOVE,20,063,245,0.169,149,0.112,-96,-0.057
KANSAS,GRAHAM,20,065,330,0.232,185,0.146,-145,-0.086
KANSAS,GRANT,20,067,549,0.207,427,0.185,-122,-0.022
KANSAS,GRAY,20,069,387,0.181,257,0.128,-130,-0.053
KANSAS,GREELEY,20,071,137,0.189,83,0.130,-54,-0.059
KANSAS,GREENWOOD,20,073,899,0.281,484,0.172,-415,-0.109
KANSAS,HAMILTON,20,075,222,0.200,114,0.135,-108,-0.065
KANSAS,HARPER,20,077,717,0.248,388,0.154,-329,-0.094
KANSAS,HARVEY,20,079,5237,0.353,5006,0.344,-231,-0.009
KANSAS,HASKELL,20,081,221,0.143,228,0.175,7,0.032
KANSAS,HODGEMAN,20,083,222,0.189,124,0.123,-98,-0.066
KANSAS,JACKSON,20,085,2026,0.349,1489,0.260,-537,-0.089
KANSAS,JEFFERSON,20,087,3226,0.371,2483,0.305,-743,-0.066
KANSAS,JEWELL,20,089,384,0.201,180,0.121,-204,-0.080
KANSAS,JOHNSON,20,091,95002,0.378,129852,0.441,34850,0.063
KANSAS,KEARNY,20,093,272,0.189,224,0.169,-48,-0.020
KANSAS,KINGMAN,20,095,902,0.240,594,0.181,-308,-0.059
KANSAS,KIOWA,20,097,253,0.165,111,0.109,-142,-0.056
KANSAS,LABETTE,20,099,3582,0.396,2234,0.282,-1348,-0.114
KANSAS,LANE,20,101,179,0.178,104,0.125,-75,-0.053
KANSAS,LEAVENWORTH,20,103,10802,0.404,10209,0.333,-593,-0.071
KANSAS,LINCOLN,20,105,390,0.219,214,0.148,-176,-0.071
KANSAS,LINN,20,107,1592,0.346,721,0.167,-871,-0.179
KANSAS,LOGAN,20,109,248,0.163,149,0.111,-99,-0.052
KANSAS,LYON,20,111,5003,0.389,4649,0.373,-354,-0.016
KANSAS,MARION,20,115,1496,0.250,1177,0.215,-319,-0.035
KANSAS,MARSHALL,20,117,1754,0.349,1060,0.232,-694,-0.117
KANSAS,MCPHERSON,20,113,3520,0.270,3183,0.256,-337,-0.014
KANSAS,MEADE,20,119,349,0.167,206,0.121,-143,-0.046
KANSAS,MIAMI,20,121,4681,0.347,3949,0.268,-732,-0.079
KANSAS,MITCHELL,20,123,687,0.208,469,0.166,-218,-0.042
KANSAS,MONTGOMERY,20,125,4254,0.307,2557,0.220,-1697,-0.087
KANSAS,MORRIS,20,127,921,0.317,586,0.228,-335,-0.089
KANSAS,MORTON,20,129,275,0.178,145,0.125,-130,-0.053
KANSAS,NEMAHA,20,131,1336,0.248,714,0.142,-622,-0.106
KANSAS,NEOSHO,20,133,2318,0.334,1464,0.238,-854,-0.096
KANSAS,NESS,20,135,379,0.211,160,0.111,-219,-0.100
KANSAS,NORTON,20,137,472,0.183,277,0.126,-195,-0.057
KANSAS,OSAGE,20,139,2482,0.340,1730,0.251,-752,-0.089
KANSAS,OSBORNE,20,141,444,0.219,231,0.132,-213,-0.087
KANSAS,OTTAWA,20,143,595,0.201,424,0.148,-171,-0.053
KANSAS,PAWNEE,20,145,759,0.258,567,0.218,-192,-0.040
KANSAS,PHILLIPS,20,147,550,0.197,296,0.113,-254,-0.084
KANSAS,POTTAWATOMIE,20,149,2147,0.247,2191,0.212,44,-0.036
KANSAS,PRATT,20,151,1181,0.274,769,0.202,-412,-0.072
KANSAS,RAWLINS,20,153,288,0.168,160,0.110,-128,-0.058
KANSAS,RENO,20,155,8739,0.332,6837,0.279,-1902,-0.053
KANSAS,REPUBLIC,20,157,601,0.211,370,0.149,-231,-0.062
KANSAS,RICE,20,159,1116,0.259,668,0.187,-448,-0.072
KANSAS,RILEY,20,161,7774,0.379,9155,0.423,1381,0.044
KANSAS,ROOKS,20,163,529,0.196,273,0.115,-256,-0.081
KANSAS,RUSH,20,165,516,0.289,227,0.154,-289,-0.135
KANSAS,RUSSELL,20,167,795,0.229,454,0.144,-341,-0.085
KANSAS,SALINE,20,169,7365,0.327,6084,0.287,-1281,-0.040
KANSAS,SCOTT,20,171,339,0.150,232,0.107,-107,-0.043
KANSAS,SEDGWICK,20,173,58619,0.362,69627,0.363,11008,0.001
KANSAS,SEWARD,20,175,1012,0.205,1491,0.314,479,0.109
KANSAS,SHAWNEE,20,177,35438,0.443,33926,0.442,-1512,-0.001
KANSAS,SHERIDAN,20,179,232,0.167,126,0.093,-106,-0.074
KANSAS,SHERMAN,20,181,630,0.230,340,0.134,-290,-0.096
KANSAS,SMITH,20,183,538,0.229,295,0.146,-243,-0.083
KANSAS,STAFFORD,20,185,506,0.233,303,0.161,-203,-0.072
KANSAS,STANTON,20,187,160,0.169,132,0.178,-28,0.009
KANSAS,STEVENS,20,189,308,0.138,215,0.116,-93,-0.022
KANSAS,SUMNER,20,191,3163,0.306,2039,0.215,-1124,-0.091
KANSAS,THOMAS,20,193,786,0.209,467,0.134,-319,-0.075
KANSAS,TREGO,20,195,434,0.258,193,0.132,-241,-0.126
KANSAS,WABAUNSEE,20,197,982,0.279,773,0.231,-209,-0.048
KANSAS,WALLACE,20,199,112,0.128,45,0.058,-67,-0.070
KANSAS,WASHINGTON,20,201,632,0.203,378,0.141,-254,-0.062
KANSAS,WICHITA,20,203,183,0.174,139,0.149,-44,-0.025
KANSAS,WILSON,20,205,1037,0.240,550,0.158,-487,-0.082
KANSAS,WOODSON,20,207,527,0.300,270,0.190,-257,-0.110
KANSAS,WYANDOTTE,20,209,32781,0.647,30146,0.612,-2635,-0.035
KENTUCKY,ADAIR,21,001,1764,0.237,1323,0.161,-441,-0.076
KENTUCKY,ALLEN,21,003,1923,0.268,1349,0.167,-574,-0.101
KENTUCKY,ANDERSON,21,005,3141,0.327,2634,0.231,-507,-0.096
KENTUCKY,BALLARD,21,007,1759,0.421,816,0.199,-943,-0.222
KENTUCKY,BARREN,21,009,5216,0.323,4275,0.231,-941,-0.092
KENTUCKY,BATH,21,011,2608,0.530,1361,0.297,-1247,-0.233
KENTUCKY,BELL,21,013,4210,0.383,1720,0.177,-2490,-0.206
KENTUCKY,BOONE,21,015,12391,0.275,15026,0.261,2635,-0.014
KENTUCKY,BOURBON,21,017,3198,0.389,2791,0.317,-407,-0.072
KENTUCKY,BOYD,21,019,10132,0.465,6021,0.294,-4111,-0.171
KENTUCKY,BOYLE,21,021,4646,0.372,4281,0.331,-365,-0.041
KENTUCKY,BRACKEN,21,023,1213,0.336,705,0.200,-508,-0.136
KENTUCKY,BREATHITT,21,025,3327,0.560,1537,0.268,-1790,-0.292
KENTUCKY,BRECKINRIDGE,21,027,2884,0.338,1960,0.223,-924,-0.115
KENTUCKY,BULLITT,21,029,9043,0.316,8255,0.229,-788,-0.087
KENTUCKY,BUTLER,21,031,1436,0.257,947,0.170,-489,-0.087
KENTUCKY,CALDWELL,21,033,2245,0.354,1260,0.211,-985,-0.143
KENTUCKY,CALLOWAY,21,035,5728,0.378,4749,0.296,-979,-0.082
KENTUCKY,CAMPBELL,21,037,14253,0.355,14658,0.345,405,-0.010
KENTUCKY,CARLISLE,21,039,1102,0.387,432,0.166,-670,-0.221
KENTUCKY,CARROLL,21,041,1688,0.433,1106,0.287,-582,-0.146
KENTUCKY,CARTER,21,043,5577,0.502,2276,0.221,-3301,-0.281
KENTUCKY,CASEY,21,045,1174,0.186,767,0.119,-407,-0.067
KENTUCKY,CHRISTIAN,21,047,6970,0.332,7188,0.325,218,-0.007
KENTUCKY,CLARK,21,049,5661,0.370,4706,0.290,-955,-0.080
KENTUCKY,CLAY,21,051,1901,0.247,752,0.111,-1149,-0.136
KENTUCKY,CLINTON,21,053,952,0.219,547,0.123,-405,-0.096
KENTUCKY,CRITTENDEN,21,055,1438,0.343,617,0.153,-821,-0.190
KENTUCKY,CUMBERLAND,21,057,848,0.262,459,0.150,-389,-0.112
KENTUCKY,DAVIESS,21,059,15788,0.381,14163,0.309,-1625,-0.072
KENTUCKY,EDMONSON,21,061,1856,0.339,979,0.187,-877,-0.152
KENTUCKY,ELLIOTT,21,063,2064,0.698,740,0.259,-1324,-0.439
KENTUCKY,ESTILL,21,065,1907,0.342,1108,0.200,-799,-0.142
KENTUCKY,FAYETTE,21,067,57994,0.462,69778,0.512,11784,0.050
KENTUCKY,FLEMING,21,069,2406,0.388,1348,0.215,-1058,-0.173
KENTUCKY,FLOYD,21,071,11132,0.622,4015,0.243,-7117,-0.379
KENTUCKY,FRANKLIN,21,073,11620,0.481,10717,0.449,-903,-0.032
KENTUCKY,FULTON,21,075,1340,0.464,774,0.325,-566,-0.139
KENTUCKY,GALLATIN,21,077,1188,0.387,749,0.224,-439,-0.163
KENTUCKY,GARRARD,21,079,1841,0.277,1453,0.191,-388,-0.086
KENTUCKY,GRANT,21,081,2818,0.319,1910,0.200,-908,-0.119
KENTUCKY,GRAVES,21,083,6206,0.382,3308,0.199,-2898,-0.183
KENTUCKY,GRAYSON,21,085,2905,0.286,1959,0.185,-946,-0.101
KENTUCKY,GREEN,21,087,1312,0.252,832,0.156,-480,-0.096
KENTUCKY,GREENUP,21,089,7630,0.464,4146,0.255,-3484,-0.209
KENTUCKY,HANCOCK,21,091,1709,0.424,1244,0.290,-465,-0.134
KENTUCKY,HARDIN,21,093,11507,0.316,13944,0.323,2437,0.007
KENTUCKY,HARLAN,21,095,4332,0.391,1372,0.128,-2960,-0.263
KENTUCKY,HARRISON,21,097,2807,0.363,2031,0.261,-776,-0.102
KENTUCKY,HART,21,099,2470,0.364,1730,0.238,-740,-0.126
KENTUCKY,HENDERSON,21,101,8101,0.433,6707,0.340,-1394,-0.093
KENTUCKY,HENRY,21,103,2366,0.364,1828,0.256,-538,-0.108
KENTUCKY,HICKMAN,21,105,926,0.395,449,0.208,-477,-0.187
KENTUCKY,HOPKINS,21,107,6420,0.341,4310,0.212,-2110,-0.129
KENTUCKY,JACKSON,21,109,769,0.149,482,0.088,-287,-0.061
KENTUCKY,JEFFERSON,21,111,170158,0.504,190836,0.540,20678,0.036
KENTUCKY,JESSAMINE,21,113,5476,0.295,6144,0.263,668,-0.032
KENTUCKY,JOHNSON,21,115,3288,0.353,1250,0.131,-2038,-0.222
KENTUCKY,KENTON,21,117,22834,0.340,24214,0.336,1380,-0.004
KENTUCKY,KNOTT,21,119,4685,0.634,1245,0.216,-3440,-0.418
KENTUCKY,KNOX,21,121,3822,0.318,1761,0.147,-2061,-0.171
KENTUCKY,LARUE,21,123,1823,0.305,1278,0.201,-545,-0.104
KENTUCKY,LAUREL,21,125,5297,0.238,3440,0.139,-1857,-0.099
KENTUCKY,LAWRENCE,21,127,2705,0.415,1045,0.173,-1660,-0.242
KENTUCKY,LEE,21,129,878,0.301,444,0.166,-434,-0.135
KENTUCKY,LESLIE,21,131,1266,0.255,400,0.089,-866,-0.166
KENTUCKY,LETCHER,21,133,4192,0.462,1542,0.169,-2650,-0.293
KENTUCKY,LEWIS,21,135,1667,0.304,785,0.148,-882,-0.156
KENTUCKY,LINCOLN,21,137,2796,0.315,1865,0.195,-931,-0.120
KENTUCKY,LIVINGSTON,21,139,2007,0.426,887,0.191,-1120,-0.235
KENTUCKY,LOGAN,21,141,3768,0.354,2755,0.253,-1013,-0.101
KENTUCKY,LYON,21,143,1769,0.451,1045,0.264,-724,-0.187
KENTUCKY,MCCRACKEN,21,145,11361,0.381,9134,0.292,-2227,-0.089
KENTUCKY,MCCREARY,21,147,1530,0.269,664,0.115,-866,-0.154
KENTUCKY,MCLEAN,21,149,1823,0.411,988,0.216,-835,-0.195
KENTUCKY,MADISON,21,151,11525,0.375,11793,0.316,268,-0.059
KENTUCKY,MAGOFFIN,21,153,2843,0.497,1172,0.229,-1671,-0.268
KENTUCKY,MARION,21,155,3399,0.462,2679,0.330,-720,-0.132
KENTUCKY,MARSHALL,21,157,6383,0.411,3672,0.220,-2711,-0.191
KENTUCKY,MARTIN,21,159,1504,0.331,363,0.092,-1141,-0.239
KENTUCKY,MASON,21,161,2644,0.373,1970,0.273,-674,-0.100
KENTUCKY,MEADE,21,163,3724,0.340,3026,0.247,-698,-0.093
KENTUCKY,MENIFEE,21,165,1284,0.508,700,0.252,-584,-0.256
KENTUCKY,MERCER,21,167,3224,0.321,2395,0.226,-829,-0.095
KENTUCKY,METCALFE,21,169,1472,0.354,976,0.211,-496,-0.143
KENTUCKY,MONROE,21,171,1158,0.198,601,0.120,-557,-0.078
KENTUCKY,MONTGOMERY,21,173,4506,0.440,3158,0.276,-1348,-0.164
KENTUCKY,MORGAN,21,175,2532,0.480,1006,0.211,-1526,-0.269
KENTUCKY,MUHLENBERG,21,177,6636,0.492,3272,0.251,-3364,-0.241
KENTUCKY,NELSON,21,179,6524,0.387,6434,0.309,-90,-0.078
KENTUCKY,NICHOLAS,21,181,1332,0.435,787,0.277,-545,-0.158
KENTUCKY,OHIO,21,183,3627,0.362,2080,0.200,-1547,-0.162
KENTUCKY,OLDHAM,21,185,8080,0.298,10268,0.313,2188,0.015
KENTUCKY,OWEN,21,187,1615,0.341,1062,0.212,-553,-0.129
KENTUCKY,OWSLEY,21,189,430,0.215,256,0.146,-174,-0.069
KENTUCKY,PENDLETON,21,191,1940,0.322,1164,0.194,-776,-0.128
KENTUCKY,PERRY,21,193,5400,0.463,2136,0.202,-3264,-0.261
KENTUCKY,PIKE,21,195,14002,0.523,4280,0.174,-9722,-0.349
KENTUCKY,POWELL,21,197,2249,0.453,1272,0.257,-977,-0.196
KENTUCKY,PULASKI,21,199,5829,0.228,4208,0.150,-1621,-0.078
KENTUCKY,ROBERTSON,21,201,413,0.379,222,0.219,-191,-0.160
KENTUCKY,ROCKCASTLE,21,203,1320,0.214,915,0.137,-405,-0.077
KENTUCKY,ROWAN,21,205,4556,0.523,3295,0.372,-1261,-0.151
KENTUCKY,RUSSELL,21,207,1772,0.227,1093,0.134,-679,-0.093
KENTUCKY,SCOTT,21,209,6325,0.371,7715,0.319,1390,-0.052
KENTUCKY,SHELBY,21,211,5277,0.323,6276,0.305,999,-0.018
KENTUCKY,SIMPSON,21,213,2730,0.388,2144,0.285,-586,-0.103
KENTUCKY,SPENCER,21,215,1970,0.289,1921,0.202,-49,-0.087
KENTUCKY,TAYLOR,21,217,2979,0.289,2553,0.226,-426,-0.063
KENTUCKY,TODD,21,219,1491,0.314,1042,0.218,-449,-0.096
KENTUCKY,TRIGG,21,221,2046,0.335,1587,0.235,-459,-0.100
KENTUCKY,TRIMBLE,21,223,1428,0.377,879,0.231,-549,-0.146
KENTUCKY,UNION,21,225,2398,0.401,1331,0.214,-1067,-0.187
KENTUCKY,WARREN,21,227,14326,0.361,16966,0.350,2640,-0.011
KENTUCKY,WASHINGTON,21,229,1724,0.329,1420,0.252,-304,-0.077
KENTUCKY,WAYNE,21,231,2616,0.340,1431,0.179,-1185,-0.161
KENTUCKY,WEBSTER,21,233,2304,0.415,1240,0.214,-1064,-0.201
KENTUCKY,WHITLEY,21,235,3985,0.292,2067,0.150,-1918,-0.142
KENTUCKY,WOLFE,21,237,1744,0.553,753,0.286,-991,-0.267
KENTUCKY,WOODFORD,21,239,4480,0.389,4958,0.366,478,-0.023
LOUISIANA,ACADIA,21,001,8937,0.354,1323,0.161,-7614,-0.193
LOUISIANA,ALLEN,22,003,3791,0.415,2106,0.228,-1685,-0.187
LOUISIANA,ASCENSION,22,005,13952,0.357,16476,0.301,2524,-0.056
LOUISIANA,ASSUMPTION,22,007,5585,0.520,3931,0.361,-1654,-0.159
LOUISIANA,AVOYELLES,22,009,6976,0.449,5035,0.304,-1941,-0.145
LOUISIANA,BEAUREGARD,22,011,3666,0.276,2393,0.159,-1273,-0.117
LOUISIANA,BIENVILLE,22,013,3221,0.469,3129,0.447,-92,-0.022
LOUISIANA,BOSSIER,22,015,12116,0.286,12641,0.254,525,-0.032
LOUISIANA,CADDO,22,017,51502,0.485,53483,0.505,1981,0.020
LOUISIANA,CALCASIEU,22,019,32844,0.412,26296,0.314,-6548,-0.098
LOUISIANA,CALDWELL,22,021,1384,0.291,788,0.168,-596,-0.123
LOUISIANA,CAMERON,22,023,1367,0.295,323,0.087,-1044,-0.208
LOUISIANA,CATAHOULA,22,025,1673,0.338,1322,0.272,-351,-0.066
LOUISIANA,CLAIBORNE,22,027,2854,0.430,2717,0.423,-137,-0.008
LOUISIANA,CONCORDIA,22,029,3446,0.384,3272,0.369,-174,-0.015
LOUISIANA,DESOTO,22,031,5026,0.443,5165,0.383,139,-0.060
LOUISIANA,EBR,22,033,82171,0.448,102828,0.523,20657,0.075
LOUISIANA,EASTCARROLL,22,035,1980,0.583,1838,0.625,-142,0.042
LOUISIANA,EASTFELICIANA,22,037,4091,0.445,4235,0.422,144,-0.023
LOUISIANA,EVANGELINE,22,039,5756,0.399,4208,0.283,-1548,-0.116
LOUISIANA,FRANKLIN,22,041,2828,0.311,2506,0.274,-322,-0.037
LOUISIANA,GRANT,22,043,1976,0.247,1181,0.134,-795,-0.113
LOUISIANA,IBERIA,22,045,12423,0.385,10698,0.330,-1725,-0.055
LOUISIANA,IBERVILLE,22,047,8063,0.543,8324,0.519,261,-0.024
LOUISIANA,JACKSON,22,049,2523,0.330,2139,0.287,-384,-0.043
LOUISIANA,JEFFERSON,22,051,71936,0.376,73670,0.406,1734,0.030
LOUISIANA,JEFFERSONDAVIS,22,053,4845,0.369,3080,0.216,-1765,-0.153
LOUISIANA,LASALLE,22,059,1154,0.185,605,0.092,-549,-0.093
LOUISIANA,LAFAYETTE,22,055,31205,0.347,32726,0.310,1521,-0.037
LOUISIANA,LAFOURCHE,22,057,14417,0.381,8423,0.202,-5994,-0.179
LOUISIANA,LINCOLN,22,061,7242,0.398,7107,0.381,-135,-0.017
LOUISIANA,LIVINGSTON,22,063,9888,0.224,6950,0.120,-2938,-0.104
LOUISIANA,MADISON,22,065,2334,0.500,2744,0.580,410,0.080
LOUISIANA,MOREHOUSE,22,067,5331,0.411,5155,0.435,-176,0.024
LOUISIANA,NATCHITOCHES,22,069,7396,0.436,7144,0.430,-252,-0.006
LOUISIANA,ORLEANES,22,071,151686,0.774,133996,0.808,-17690,0.034
LOUISIANA,OUACHITA,22,073,22011,0.342,24428,0.359,2417,0.017
LOUISIANA,PLAQUEMINES,22,075,4181,0.344,3347,0.317,-834,-0.027
LOUISIANA,POINTECOUPEE,22,077,5712,0.507,4764,0.405,-948,-0.102
LOUISIANA,RAPIDES,22,079,18904,0.349,18322,0.322,-582,-0.027
LOUISIANA,REDRIVER,22,081,2140,0.452,1938,0.438,-202,-0.014
LOUISIANA,RICHLAND,22,083,3082,0.356,3157,0.329,75,-0.027
LOUISIANA,SABINE,22,085,2741,0.286,1703,0.174,-1038,-0.112
LOUISIANA,STBERNARD,22,087,9956,0.334,4960,0.314,-4996,-0.020
LOUISIANA,STCHARLES,22,089,8895,0.373,8559,0.327,-336,-0.046
LOUISIANA,STHELENA,22,091,3173,0.576,3353,0.562,180,-0.014
LOUISIANA,STJAMES,22,093,6406,0.575,6418,0.531,12,-0.044
LOUISIANA,STJON,22,095,10293,0.528,12661,0.610,2368,0.082
LOUISIANA,STLANDRY,22,097,18162,0.494,17209,0.430,-953,-0.064
LOUISIANA,STMARTIN,22,099,10319,0.452,8266,0.321,-2053,-0.131
LOUISIANA,STMARY,22,101,9544,0.421,8050,0.352,-1494,-0.069
LOUISIANA,STTAMMANY,22,103,24643,0.245,27717,0.223,3074,-0.022
LOUISIANA,TANGIPAHOA,22,105,15335,0.364,16878,0.322,1543,-0.042
LOUISIANA,TENSAS,22,107,1468,0.496,1332,0.523,-136,0.027
LOUISIANA,TERREBONNE,22,109,13678,0.337,10665,0.243,-3013,-0.094
LOUISIANA,UNION,22,111,3058,0.286,2691,0.247,-367,-0.039
LOUISIANA,VERM,22,113,9083,0.370,4857,0.189,-4226,-0.181
LOUISIANA,VERNON,22,115,4035,0.264,2665,0.160,-1370,-0.104
LOUISIANA,WASHINGTON,22,117,6554,0.367,5692,0.306,-862,-0.061
LOUISIANA,WEBSTER,22,119,6821,0.370,6260,0.345,-561,-0.025
LOUISIANA,WBR,22,121,4931,0.455,5383,0.423,452,-0.032
LOUISIANA,WESTCARROLL,22,123,1231,0.245,715,0.150,-516,-0.095
LOUISIANA,WESTFELICIANA,22,125,2214,0.433,2248,0.388,34,-0.045
LOUISIANA,WINN,22,127,2056,0.316,1644,0.258,-412,-0.058
MARYLAND,ALLEGANY,24,001,10576,0.354,7875,0.257,-2701,-0.097
MARYLAND,ANNEARUNDEL,24,003,103324,0.431,128419,0.475,25095,0.044
MARYLAND,BALTIMORE,24,005,175022,0.820,202673,0.847,27651,0.027
MARYLAND,BALTIMORE,24,005,182474,0.516,202673,0.847,20199,0.331
MARYLAND,CALVERT,24,009,15967,0.406,18225,0.384,2258,-0.022
MARYLAND,CAROLINE,24,011,3810,0.336,4009,0.284,199,-0.052
MARYLAND,CARROLL,24,013,22974,0.290,26567,0.289,3593,-0.001
MARYLAND,CECIL,24,015,14680,0.390,13650,0.302,-1030,-0.088
MARYLAND,CHARLES,24,017,29354,0.504,49341,0.630,19987,0.126
MARYLAND,DORCHESTER,24,019,5411,0.406,6245,0.410,834,0.004
MARYLAND,FREDERICK,24,021,39503,0.393,56522,0.450,17019,0.057
MARYLAND,GARRETT,24,023,3291,0.264,2567,0.183,-724,-0.081
MARYLAND,HARFORD,24,025,39685,0.352,47077,0.352,7392,0.000
MARYLAND,HOWARD,24,027,72257,0.540,102597,0.633,30340,0.093
MARYLAND,KENT,24,029,4278,0.461,4575,0.457,297,-0.004
MARYLAND,MONTGOMERY,24,031,273936,0.660,357837,0.747,83901,0.087
MARYLAND,PRINCEGEORGES,24,033,260532,0.818,344049,0.881,83517,0.063
MARYLAND,QUEENANNES,24,035,7070,0.324,7973,0.301,903,-0.023
MARYLAND,STMARYS,24,037,13776,0.363,17534,0.352,3758,-0.011
MARYLAND,SOMERSET,24,039,4034,0.449,4196,0.424,162,-0.025
MARYLAND,TALBOT,24,041,7367,0.391,8653,0.421,1286,0.030
MARYLAND,WASHINGTON,24,043,20387,0.352,21129,0.320,742,-0.032
MARYLAND,WICOMICO,24,045,15137,0.404,18050,0.424,2913,0.020
MARYLAND,WORCESTER,24,047,9648,0.382,9753,0.345,105,-0.037
MASSACHUSETTS,SUFFOLK,25,025,182592,0.756,245751,0.784,63159,0.028
MASSACHUSETTS,BERKSHIRE,25,003,47743,0.731,43714,0.666,-4029,-0.065
MASSACHUSETTS,DUKES,25,007,7265,0.727,8400,0.720,1135,-0.007
MASSACHUSETTS,HAMPSHIRE,25,015,51680,0.694,55367,0.658,3687,-0.036
MASSACHUSETTS,FRANKLIN,25,011,25550,0.684,24478,0.631,-1072,-0.053
MASSACHUSETTS,MIDDLESEX,25,017,440862,0.640,520360,0.653,79498,0.013
MASSACHUSETTS,BRISTOL,25,005,147854,0.635,129540,0.514,-18314,-0.121
MASSACHUSETTS,NANTUCKET,25,019,3608,0.630,4146,0.637,538,0.007
MASSACHUSETTS,HAMPDEN,25,013,113710,0.609,112590,0.546,-1120,-0.063
MASSACHUSETTS,NORFOLK,25,021,199392,0.602,221819,0.603,22427,0.001
MASSACHUSETTS,ESSEX,25,009,194068,0.582,222310,0.577,28242,-0.005
MASSACHUSETTS,WORCESTER,25,027,192142,0.564,198778,0.510,6636,-0.054
MASSACHUSETTS,BARNSTABLE,25,001,72156,0.546,72430,0.533,274,-0.013
MASSACHUSETTS,PLYMOUTH,25,023,125178,0.537,135513,0.500,10335,-0.037
MINNESOTA,AITKIN,27,001,4539,0.480,3134,0.340,-1405,-0.140
MINNESOTA,ANOKA,27,003,80226,0.461,75500,0.406,-4726,-0.055
MINNESOTA,BECKER,27,005,6756,0.402,5208,0.302,-1548,-0.100
MINNESOTA,BELTRAMI,27,007,10592,0.501,8688,0.403,-1904,-0.098
MINNESOTA,BENTON,27,009,8059,0.438,5640,0.281,-2419,-0.157
MINNESOTA,BIGSTONE,27,011,1536,0.501,921,0.334,-615,-0.167
MINNESOTA,BLUEEARTH,27,013,16865,0.509,14428,0.429,-2437,-0.080
MINNESOTA,BROWN,27,015,5158,0.374,3763,0.273,-1395,-0.101
MINNESOTA,CARLTON,27,017,11462,0.625,8460,0.465,-3002,-0.160
MINNESOTA,CARVER,27,019,16456,0.362,21508,0.386,5052,0.024
MINNESOTA,CASS,27,021,6835,0.430,4949,0.309,-1886,-0.121
MINNESOTA,CHIPPEWA,27,023,3424,0.518,1978,0.318,-1446,-0.200
MINNESOTA,CHISAGO,27,025,12219,0.432,9278,0.307,-2941,-0.125
MINNESOTA,CLAY,27,027,12989,0.468,12971,0.441,-18,-0.027
MINNESOTA,CLEARWATER,27,029,1871,0.429,1100,0.259,-771,-0.170
MINNESOTA,COOK,27,031,1733,0.525,1912,0.563,179,0.038
MINNESOTA,COTTONWOOD,27,033,2726,0.428,1678,0.293,-1048,-0.135
MINNESOTA,CROWWING,27,035,14005,0.417,10982,0.306,-3023,-0.111
MINNESOTA,DAKOTA,27,037,104635,0.485,110483,0.477,5848,-0.008
MINNESOTA,DODGE,27,039,4117,0.417,3102,0.291,-1015,-0.126
MINNESOTA,DOUGLAS,27,041,8219,0.405,6227,0.286,-1992,-0.119
MINNESOTA,FARIBAULT,27,043,3767,0.434,2153,0.290,-1614,-0.144
MINNESOTA,FILLMORE,27,045,5825,0.498,3872,0.350,-1953,-0.148
MINNESOTA,FREEBORN,27,047,9733,0.551,6041,0.376,-3692,-0.175
MINNESOTA,GOODHUE,27,049,12103,0.473,9446,0.367,-2657,-0.106
MINNESOTA,GRANT,27,051,1856,0.486,1105,0.318,-751,-0.168
MINNESOTA,HENNEPIN,27,053,383841,0.593,429288,0.631,45447,0.038
MINNESOTA,HOUSTON,27,055,5276,0.476,4145,0.391,-1131,-0.085
MINNESOTA,HUBBARD,27,057,4741,0.418,3423,0.298,-1318,-0.120
MINNESOTA,ISANTI,27,059,7883,0.408,5657,0.269,-2226,-0.139
MINNESOTA,ITASCA,27,061,13290,0.545,9015,0.378,-4275,-0.167
MINNESOTA,JACKSON,27,063,2652,0.459,1492,0.272,-1160,-0.187
MINNESOTA,KANABEC,27,065,3592,0.435,2327,0.285,-1265,-0.150
MINNESOTA,KANDIYOHI,27,067,9337,0.437,7266,0.334,-2071,-0.103
MINNESOTA,KITTSON,27,069,1333,0.497,823,0.345,-510,-0.152
MINNESOTA,KOOCHICHING,27,071,3662,0.501,2306,0.362,-1356,-0.139
MINNESOTA,LAQUIPARLE,27,073,2390,0.526,1305,0.338,-1085,-0.188
MINNESOTA,LAKE,27,075,4212,0.596,3077,0.472,-1135,-0.124
MINNESOTA,LAKEOFTHEWOODS,27,077,921,0.384,553,0.247,-368,-0.137
MINNESOTA,LESUEUR,27,079,6466,0.448,4623,0.309,-1843,-0.139
MINNESOTA,LINCOLN,27,081,1558,0.466,860,0.285,-698,-0.181
MINNESOTA,LYON,27,083,5292,0.418,3825,0.313,-1467,-0.105
MINNESOTA,MCLEOD,27,085,6712,0.365,4978,0.265,-1734,-0.100
MINNESOTA,MAHNOMEN,27,087,1339,0.534,930,0.445,-409,-0.089
MINNESOTA,MARSHALL,27,089,2308,0.415,1225,0.254,-1083,-0.161
MINNESOTA,MARTIN,27,091,4590,0.415,2733,0.260,-1857,-0.155
MINNESOTA,MEEKER,27,093,5292,0.429,3191,0.260,-2101,-0.169
MINNESOTA,MILLELACS,27,095,5677,0.435,3710,0.285,-1967,-0.150
MINNESOTA,MORRISON,27,097,6794,0.405,3637,0.206,-3157,-0.199
MINNESOTA,MOWER,27,099,12334,0.610,7437,0.420,-4897,-0.190
MINNESOTA,MURRAY,27,101,2218,0.444,1295,0.277,-923,-0.167
MINNESOTA,NICOLLET,27,103,8797,0.496,7886,0.436,-911,-0.060
MINNESOTA,NOBLES,27,105,3898,0.424,2733,0.317,-1165,-0.107
MINNESOTA,NORMAN,27,107,1954,0.513,1264,0.388,-690,-0.125
MINNESOTA,OLMSTED,27,109,33285,0.465,36268,0.453,2983,-0.012
MINNESOTA,OTTERTAIL,27,111,12038,0.374,9340,0.287,-2698,-0.087
MINNESOTA,PENNINGTON,27,113,3117,0.444,2147,0.320,-970,-0.124
MINNESOTA,PINE,27,115,7228,0.498,4580,0.332,-2648,-0.166
MINNESOTA,PIPESTONE,27,117,1900,0.378,1127,0.234,-773,-0.144
MINNESOTA,POLK,27,119,6729,0.429,4712,0.318,-2017,-0.111
MINNESOTA,POPE,27,121,3301,0.493,2106,0.333,-1195,-0.160
MINNESOTA,RAMSEY,27,123,171846,0.630,177738,0.651,5892,0.021
MINNESOTA,REDLAKE,27,125,963,0.442,540,0.287,-423,-0.155
MINNESOTA,REDWOOD,27,127,3104,0.381,1887,0.248,-1217,-0.133
MINNESOTA,RENVILLE,27,129,3787,0.454,2117,0.278,-1670,-0.176
MINNESOTA,RICE,27,131,16425,0.534,14437,0.445,-1988,-0.089
MINNESOTA,ROCK,27,133,2000,0.385,1373,0.284,-627,-0.101
MINNESOTA,ROSEAU,27,135,2442,0.309,1856,0.238,-586,-0.071
MINNESOTA,STLOUIS,27,137,77958,0.652,57771,0.514,-20187,-0.138
MINNESOTA,SCOTT,27,139,23958,0.395,28502,0.380,4544,-0.015
MINNESOTA,SHERBURNE,27,141,15816,0.382,13293,0.275,-2523,-0.107
MINNESOTA,SIBLEY,27,143,3109,0.391,1954,0.251,-1155,-0.140
MINNESOTA,STEARNS,27,145,32659,0.432,25576,0.321,-7083,-0.111
MINNESOTA,STEELE,27,147,7994,0.428,6241,0.325,-1753,-0.103
MINNESOTA,STEVENS,27,149,2821,0.474,2116,0.392,-705,-0.082
MINNESOTA,SWIFT,27,151,3165,0.552,1686,0.338,-1479,-0.214
MINNESOTA,TODD,27,153,5034,0.412,2783,0.232,-2251,-0.180
MINNESOTA,TRAVERSE,27,155,1026,0.479,630,0.350,-396,-0.129
MINNESOTA,WABASHA,27,157,5548,0.469,3866,0.327,-1682,-0.142
MINNESOTA,WADENA,27,159,2791,0.393,1684,0.243,-1107,-0.150
MINNESOTA,WASECA,27,161,4179,0.426,2838,0.294,-1341,-0.132
MINNESOTA,WASHINGTON,27,163,61395,0.478,67086,0.465,5691,-0.013
MINNESOTA,WATONWAN,27,165,2514,0.450,1814,0.363,-700,-0.087
MINNESOTA,WILKIN,27,167,1169,0.331,893,0.270,-276,-0.061
MINNESOTA,WINONA,27,169,14231,0.519,11366,0.436,-2865,-0.083
MINNESOTA,WRIGHT,27,171,22618,0.380,20334,0.292,-2284,-0.088
MINNESOTA,YELLOWMEDICINE,27,173,2799,0.486,1524,0.289,-1275,-0.197
MISSISSIPPI,ADAMS,28,001,7844,0.546,7757,0.561,-87,0.015
MISSISSIPPI,ALCORN,28,003,5364,0.380,2684,0.182,-2680,-0.198
MISSISSIPPI,AMITE,28,005,2973,0.418,2697,0.383,-276,-0.035
MISSISSIPPI,ATTALA,28,007,3014,0.379,3242,0.393,228,0.014
MISSISSIPPI,BENTON,28,009,2234,0.528,1719,0.427,-515,-0.101
MISSISSIPPI,BOLIVAR,28,011,8560,0.637,9046,0.654,486,0.017
MISSISSIPPI,CALHOUN,28,013,2211,0.349,1910,0.299,-301,-0.050
MISSISSIPPI,CARROLL,28,015,1897,0.340,1680,0.304,-217,-0.036
MISSISSIPPI,CHICKASAW,28,017,3991,0.487,3649,0.462,-342,-0.025
MISSISSIPPI,CHOCTAW,28,019,1290,0.330,1218,0.300,-72,-0.030
MISSISSIPPI,CLAIBORNE,28,021,4338,0.815,3708,0.868,-630,0.053
MISSISSIPPI,CLARKE,28,023,2377,0.320,2585,0.332,208,0.012
MISSISSIPPI,CLAY,28,025,4732,0.519,5722,0.572,990,0.053
MISSISSIPPI,COAHKOMA,28,027,6741,0.641,6378,0.716,-363,0.075
MISSISSIPPI,COPIAH,28,029,4902,0.435,6741,0.519,1839,0.084
MISSISSIPPI,COVINGTON,28,031,3135,0.383,3276,0.372,141,-0.011
MISSISSIPPI,DESOTO,28,033,13247,0.271,20591,0.311,7344,0.040
MISSISSIPPI,FORREST,28,035,9781,0.377,11716,0.417,1935,0.040
MISSISSIPPI,FRANKLIN,28,037,1566,0.350,1502,0.350,-64,-0.000
MISSISSIPPI,GEORGE,28,039,1715,0.216,1027,0.104,-688,-0.112
MISSISSIPPI,GREENE,28,041,1419,0.269,974,0.181,-445,-0.088
MISSISSIPPI,GRENDADA,28,043,4154,0.413,4424,0.421,270,0.008
MISSISSIPPI,HANCOCK,28,045,5023,0.286,3344,0.190,-1679,-0.096
MISSISSIPPI,HARRISON,28,047,22555,0.365,21169,0.334,-1386,-0.031
MISSISSIPPI,HINDS,28,049,51370,0.595,67594,0.711,16224,0.116
MISSISSIPPI,HOLMES,28,051,6170,0.759,6689,0.828,519,0.069
MISSISSIPPI,HUMP,28,053,2975,0.640,3071,0.722,96,0.082
MISSISSIPPI,ISSAQUENA,28,055,510,0.530,395,0.565,-115,0.035
MISSISSIPPI,ITAWAMBA,28,057,2771,0.289,1117,0.115,-1654,-0.174
MISSISSIPPI,JACKSON,28,059,15046,0.304,14657,0.296,-389,-0.008
MISSISSIPPI,JASPER,28,061,4081,0.515,4368,0.515,287,0.000
MISSISSIPPI,JD,28,065,2955,0.513,3720,0.596,765,0.083
MISSISSIPPI,JEFFERSON,28,063,2798,0.813,3337,0.865,539,0.052
MISSISSIPPI,JONES,28,067,7344,0.277,7791,0.275,447,-0.002
MISSISSIPPI,KEMPER,28,069,2454,0.535,2827,0.609,373,0.074
MISSISSIPPI,LAFAYETTE,28,071,6218,0.404,7969,0.406,1751,0.002
MISSISSIPPI,LAMAR,28,073,3876,0.191,5190,0.211,1314,0.020
MISSISSIPPI,LAUDERDALE,28,075,10026,0.339,11269,0.382,1243,0.043
MISSISSIPPI,LAWRENCE,28,077,2355,0.361,2195,0.345,-160,-0.016
MISSISSIPPI,LEAKE,28,079,1698,0.396,3584,0.424,1886,0.028
MISSISSIPPI,LEE,28,081,9895,0.330,10029,0.305,134,-0.025
MISSISSIPPI,LEFLORE,28,083,7240,0.620,7787,0.699,547,0.079
MISSISSIPPI,LINCOLN,28,085,4372,0.305,4458,0.293,86,-0.012
MISSISSIPPI,LOWNDES,28,087,7904,0.381,11819,0.460,3915,0.079
MISSISSIPPI,MADISON,28,089,12942,0.348,20343,0.406,7401,0.058
MISSISSIPPI,MARION,28,091,3828,0.326,3677,0.314,-151,-0.012
MISSISSIPPI,MARSHALL,28,093,7979,0.588,8023,0.541,44,-0.047
MISSISSIPPI,MONROE,28,095,6149,0.398,5524,0.348,-625,-0.050
MISSISSIPPI,MONT,28,097,2422,0.449,2115,0.423,-307,-0.026
MISSISSIPPI,NESHOBA,28,099,2515,0.248,2715,0.257,200,0.009
MISSISSIPPI,NEWTON,28,101,2274,0.268,2756,0.292,482,0.024
MISSISSIPPI,NOX,28,103,4293,0.713,4347,0.780,54,0.067
MISSISSIPPI,OKT,28,105,4178,0.429,8859,0.489,4681,0.060
MISSISSIPPI,PANOLA,28,107,6540,0.491,7431,0.493,891,0.002
MISSISSIPPI,PR,28,109,4392,0.230,3604,0.165,-788,-0.065
MISSISSIPPI,PERRY,28,111,1259,0.251,1220,0.225,-39,-0.026
MISSISSIPPI,PIKE,28,113,7578,0.467,8043,0.492,465,0.025
MISSISSIPPI,PONT,28,115,2591,0.234,2386,0.184,-205,-0.050
MISSISSIPPI,PRENT,28,117,2119,0.320,2067,0.209,-52,-0.111
MISSISSIPPI,QUITMAN,28,119,1925,0.598,2312,0.687,387,0.089
MISSISSIPPI,RANKIN,28,121,10738,0.201,14110,0.224,3372,0.023
MISSISSIPPI,SCOTT,28,123,3780,0.371,4268,0.406,488,0.035
MISSISSIPPI,SHARKEY,28,125,1553,0.504,1479,0.675,-74,0.171
MISSISSIPPI,SIMPSON,28,127,3262,0.324,3874,0.339,612,0.015
MISSISSIPPI,SMITH,28,129,1493,0.210,1617,0.212,124,0.002
MISSISSIPPI,STONE,28,131,1502,0.267,1573,0.223,71,-0.044
MISSISSIPPI,SUN,28,133,6057,0.627,6725,0.701,668,0.074
MISSISSIPPI,TALL,28,135,3377,0.548,3337,0.568,-40,0.020
MISSISSIPPI,TATE,28,137,4279,0.389,3926,0.338,-353,-0.051
MISSISSIPPI,TIPPAH,28,139,2983,0.327,1842,0.199,-1141,-0.128
MISSISSIPPI,TISH,28,141,2775,0.340,999,0.119,-1776,-0.221
MISSISSIPPI,TUNICA,28,143,1934,0.687,2667,0.748,733,0.061
MISSISSIPPI,UNION,28,145,2710,0.266,2012,0.175,-698,-0.091
MISSISSIPPI,WALTHALL,28,147,2550,0.395,2790,0.403,240,0.008
MISSISSIPPI,WARREN,28,149,8244,0.410,9284,0.478,1040,0.068
MISSISSIPPI,WASHINGTON,28,151,10562,0.591,11380,0.676,818,0.085
MISSISSIPPI,WAYNE,28,153,3193,0.363,3524,0.367,331,0.004
MISSISSIPPI,WEBSTER,28,155,1318,0.264,1019,0.201,-299,-0.062
MISSISSIPPI,WILK,28,157,2794,0.637,2857,0.677,63,0.040
MISSISSIPPI,WINSTON,28,159,2859,0.532,3850,0.434,991,-0.098
MISSISSIPPI,YALO,28,161,2656,0.445,2582,0.425,-74,-0.020
MISSISSIPPI,YAZOO,28,163,4798,0.449,5369,0.533,571,0.084
MISSOURI,ADAIR,29,001,4938,0.433,3500,0.342,-1438,-0.091
MISSOURI,ANDREW,29,003,3069,0.371,2045,0.222,-1024,-0.149
MISSOURI,ATCHISON,29,005,1005,0.318,541,0.198,-464,-0.120
MISSOURI,AUDRAIN,29,007,4318,0.404,2570,0.254,-1748,-0.150
MISSOURI,BARRY,29,009,4223,0.303,2710,0.186,-1513,-0.117
MISSOURI,BARTON,29,011,1373,0.229,795,0.134,-578,-0.095
MISSOURI,BATES,29,013,3398,0.401,1618,0.200,-1780,-0.201
MISSOURI,BENTON,29,015,3381,0.375,2025,0.211,-1356,-0.164
MISSOURI,BOLLINGER,29,017,1754,0.298,705,0.124,-1049,-0.174
MISSOURI,BOONE,29,019,37643,0.495,41125,0.490,3482,-0.005
MISSOURI,BUCHANAN,29,021,17799,0.469,12013,0.334,-5786,-0.135
MISSOURI,BUTLER,29,023,4666,0.284,3036,0.176,-1630,-0.108
MISSOURI,CALDWELL,29,025,1645,0.385,838,0.194,-807,-0.191
MISSOURI,CALLAWAY,29,027,6559,0.369,4989,0.258,-1570,-0.111
MISSOURI,CAMDEN,29,029,6296,0.323,4768,0.211,-1528,-0.112
MISSOURI,CAPEGIRARDEAU,29,031,10568,0.306,8492,0.228,-2076,-0.078
MISSOURI,CARROLL,29,033,1568,0.331,745,0.171,-823,-0.160
MISSOURI,CARTER,29,035,964,0.347,436,0.153,-528,-0.194
MISSOURI,CASS,29,037,16681,0.377,14846,0.289,-1835,-0.088
MISSOURI,CEDAR,29,039,1910,0.308,1011,0.160,-899,-0.148
MISSOURI,CHARITON,29,041,1892,0.436,888,0.224,-1004,-0.212
MISSOURI,CHRISTIAN,29,043,9059,0.289,8508,0.203,-551,-0.086
MISSOURI,CLARK,29,045,1794,0.480,724,0.218,-1070,-0.262
MISSOURI,CLAY,29,047,44670,0.463,45304,0.408,634,-0.055
MISSOURI,CLINTON,29,049,4165,0.437,2572,0.250,-1593,-0.187
MISSOURI,COLE,29,051,11753,0.320,10913,0.290,-840,-0.030
MISSOURI,COOPER,29,053,2400,0.320,1932,0.242,-468,-0.078
MISSOURI,CRAWFORD,29,055,3632,0.387,1824,0.184,-1808,-0.203
MISSOURI,DADE,29,057,1104,0.270,637,0.161,-467,-0.109
MISSOURI,DALLAS,29,059,2407,0.332,1272,0.171,-1135,-0.161
MISSOURI,DAVIESS,29,061,1402,0.370,730,0.195,-672,-0.175
MISSOURI,DEKALB,29,063,1707,0.364,824,0.178,-883,-0.186
MISSOURI,DENT,29,065,1865,0.296,978,0.144,-887,-0.152
MISSOURI,DOUGLAS,29,067,1741,0.275,984,0.148,-757,-0.127
MISSOURI,DUNKLIN,29,069,4901,0.420,2360,0.223,-2541,-0.197
MISSOURI,FRANKLIN,29,071,18556,0.409,12341,0.245,-6215,-0.164
MISSOURI,GASCONADE,29,073,2355,0.328,1520,0.204,-835,-0.124
MISSOURI,GENTRY,29,075,1201,0.363,605,0.199,-596,-0.164
MISSOURI,GREENE,29,077,46657,0.372,42728,0.327,-3929,-0.045
MISSOURI,GRUNDY,29,079,1561,0.325,780,0.176,-781,-0.149
MISSOURI,HARRISON,29,081,1279,0.316,574,0.156,-705,-0.160
MISSOURI,HENRY,29,083,4461,0.410,2357,0.238,-2104,-0.172
MISSOURI,HICKORY,29,085,2043,0.420,1016,0.215,-1027,-0.205
MISSOURI,HOLT,29,087,811,0.301,347,0.147,-464,-0.154
MISSOURI,HOWARD,29,089,1972,0.401,1283,0.264,-689,-0.137
MISSOURI,HOWELL,29,091,5118,0.312,2881,0.165,-2237,-0.147
MISSOURI,IRON,29,093,2157,0.461,933,0.219,-1224,-0.242
MISSOURI,JACKSON,29,095,183654,0.581,168972,0.555,-14682,-0.026
MISSOURI,JASPER,29,097,13002,0.288,10572,0.219,-2430,-0.069
MISSOURI,JEFFERSON,29,099,46057,0.494,31568,0.295,-14489,-0.199
MISSOURI,JOHNSON,29,101,7790,0.385,5930,0.278,-1860,-0.107
MISSOURI,KNOX,29,103,761,0.385,379,0.203,-382,-0.182
MISSOURI,LACLEDE,29,105,4213,0.283,2553,0.158,-1660,-0.125
MISSOURI,LAFAYETTE,29,107,6412,0.396,4053,0.254,-2359,-0.142
MISSOURI,LAWRENCE,29,109,4506,0.285,2901,0.173,-1605,-0.112
MISSOURI,LEWIS,29,111,1754,0.378,934,0.208,-820,-0.170
MISSOURI,LINCOLN,29,113,8368,0.422,5575,0.222,-2793,-0.200
MISSOURI,LINN,29,115,2440,0.414,1240,0.222,-1200,-0.192
MISSOURI,LIVINGSTON,29,117,2278,0.359,1265,0.197,-1013,-0.162
MISSOURI,MCDONALD,29,119,2215,0.287,1329,0.161,-886,-0.126
MISSOURI,MACON,29,121,2856,0.377,1548,0.203,-1308,-0.174
MISSOURI,MADISON,29,123,1972,0.401,1005,0.189,-967,-0.212
MISSOURI,MARIES,29,125,1563,0.353,794,0.176,-769,-0.177
MISSOURI,MARION,29,127,4568,0.367,2994,0.231,-1574,-0.136
MISSOURI,MERCER,29,129,582,0.320,216,0.124,-366,-0.196
MISSOURI,MILLER,29,131,2959,0.273,1750,0.152,-1209,-0.121
MISSOURI,MISSISSIPPI,29,133,2374,0.448,1458,0.282,-916,-0.166
MISSOURI,MONITEAU,29,135,1913,0.286,1237,0.181,-676,-0.105
MISSOURI,MONROE,29,137,1647,0.382,853,0.205,-794,-0.177
MISSOURI,MONTGOMERY,29,139,2147,0.373,1119,0.206,-1028,-0.167
MISSOURI,MORGAN,29,141,3053,0.348,1768,0.200,-1285,-0.148
MISSOURI,NEWMADRID,29,143,3716,0.470,1933,0.263,-1783,-0.207
MISSOURI,NEWTON,29,145,6564,0.275,4990,0.186,-1574,-0.089
MISSOURI,NODAWAY,29,147,3830,0.378,2529,0.267,-1301,-0.111
MISSOURI,OREGON,29,149,1823,0.390,865,0.185,-958,-0.205
MISSOURI,OSAGE,29,151,1673,0.251,998,0.141,-675,-0.110
MISSOURI,OZARK,29,153,1561,0.332,724,0.161,-837,-0.171
MISSOURI,PEMISCOT,29,155,3381,0.497,1947,0.323,-1434,-0.174
MISSOURI,PERRY,29,157,2621,0.318,1520,0.174,-1101,-0.144
MISSOURI,PETTIS,29,159,5801,0.332,4324,0.238,-1477,-0.094
MISSOURI,PHELPS,29,161,6666,0.356,4766,0.255,-1900,-0.101
MISSOURI,PIKE,29,163,3670,0.456,1806,0.245,-1864,-0.211
MISSOURI,PLATTE,29,165,18412,0.439,20057,0.404,1645,-0.035
MISSOURI,POLK,29,167,3775,0.303,2631,0.191,-1144,-0.112
MISSOURI,PULASKI,29,169,3551,0.291,2922,0.217,-629,-0.074
MISSOURI,PUTNAM,29,171,772,0.316,353,0.150,-419,-0.166
MISSOURI,RALLS,29,173,2031,0.403,1138,0.215,-893,-0.188
MISSOURI,RANDOLPH,29,175,3586,0.352,2283,0.221,-1303,-0.131
MISSOURI,RAY,29,177,5034,0.467,3090,0.284,-1944,-0.183
MISSOURI,REYNOLDS,29,179,1449,0.431,540,0.178,-909,-0.253
MISSOURI,RIPLEY,29,181,1907,0.337,830,0.150,-1077,-0.187
MISSOURI,STCHARLES,29,183,66855,0.409,68626,0.338,1771,-0.071
MISSOURI,STCLAIR,29,185,1841,0.371,936,0.202,-905,-0.169
MISSOURI,STGENEVIEVE,29,186,4281,0.526,2542,0.300,-1739,-0.226
MISSOURI,STFRANCOIS,29,187,10748,0.469,6250,0.251,-4498,-0.218
MISSOURI,STLOUISCITY,29,510,116133,0.803,6250,0.251,-4498,-0.218
MISSOURI,STLOUIS,29,189,295284,0.544,104235,0.787,-191049,0.243
MISSOURI,SALINE,29,195,4479,0.451,2789,0.301,-1690,-0.150
MISSOURI,SCHUYLER,29,197,894,0.440,354,0.183,-540,-0.257
MISSOURI,SCOTLAND,29,199,828,0.377,365,0.185,-463,-0.192
MISSOURI,SCOTT,29,201,6057,0.347,3575,0.206,-2482,-0.141
MISSOURI,SHANNON,29,203,1618,0.388,776,0.199,-842,-0.189
MISSOURI,SHELBY,29,205,1201,0.343,606,0.185,-595,-0.158
MISSOURI,STODDARD,29,207,3946,0.298,1876,0.141,-2070,-0.157
MISSOURI,STONE,29,209,4578,0.301,2887,0.173,-1691,-0.128
MISSOURI,SULLIVAN,29,211,1178,0.381,526,0.212,-652,-0.169
MISSOURI,TANEY,29,213,5601,0.291,4373,0.185,-1228,-0.106
MISSOURI,TEXAS,29,215,3664,0.333,1728,0.158,-1936,-0.175
MISSOURI,VERNON,29,217,3206,0.357,1707,0.198,-1499,-0.159
MISSOURI,WARREN,29,219,5461,0.407,3915,0.248,-1546,-0.159
MISSOURI,WASHINGTON,29,221,4459,0.486,1926,0.207,-2533,-0.279
MISSOURI,WAYNE,29,223,2250,0.363,948,0.165,-1302,-0.198
MISSOURI,WEBSTER,29,225,4657,0.312,3177,0.190,-1480,-0.122
MISSOURI,WORTH,29,227,436,0.385,195,0.186,-241,-0.199
MISSOURI,WRIGHT,29,229,2188,0.262,1170,0.144,-1018,-0.118
MONTANA,BEAVERHEAD,30,001,599,0.218,1143,0.236,544,0.018
MONTANA,BIGHORN,30,003,2213,0.514,2094,0.494,-119,-0.020
MONTANA,BLAINE,30,005,1300,0.460,1202,0.448,-98,-0.012
MONTANA,BROADWATER,30,007,533,0.226,573,0.183,40,-0.043
MONTANA,CARBON,30,009,1847,0.347,1828,0.305,-19,-0.042
MONTANA,CARTER,30,011,76,0.107,70,0.089,-6,-0.018
MONTANA,CASCADE,30,013,10425,0.395,12175,0.352,1750,-0.043
MONTANA,CHOUTEAU,30,015,941,0.322,732,0.281,-209,-0.041
MONTANA,CUSTER,30,017,1629,0.323,1176,0.227,-453,-0.096
MONTANA,DANIELS,30,019,326,0.291,168,0.175,-158,-0.116
MONTANA,DAWSON,30,021,1494,0.333,787,0.178,-707,-0.155
MONTANA,DEERLODGE,30,023,1775,0.592,2058,0.489,283,-0.103
MONTANA,FALLON,30,025,289,0.194,154,0.104,-135,-0.090
MONTANA,FERGUS,30,027,668,0.245,1202,0.206,534,-0.039
MONTANA,FLATHEAD,30,029,11587,0.300,13293,0.280,1706,-0.020
MONTANA,GALLATIN,30,031,10661,0.433,24246,0.451,13585,0.018
MONTANA,GARFIELD,30,033,52,0.079,34,0.047,-18,-0.032
MONTANA,GLACIER,30,035,2641,0.579,3121,0.615,480,0.036
MONTANA,GOLDENVALLEY,30,037,119,0.228,71,0.150,-48,-0.078
MONTANA,GRANITE,30,039,404,0.252,472,0.266,68,0.014
MONTANA,HILL,30,041,2300,0.424,2371,0.368,71,-0.056
MONTANA,JEFFERSON,30,043,1880,0.320,1998,0.298,118,-0.022
MONTANA,JUDITHBASIN,30,045,322,0.251,235,0.195,-87,-0.056
MONTANA,LAKE,30,047,2425,0.371,4776,0.362,2351,-0.009
MONTANA,LEWISANDCLARK,30,049,12655,0.426,14478,0.410,1823,-0.016
MONTANA,LIBERTY,30,051,281,0.272,206,0.214,-75,-0.058
MONTANA,LINCOLN,30,053,1656,0.289,2041,0.219,385,-0.070
MONTANA,MADISON,30,057,983,0.250,1180,0.249,197,-0.001
MONTANA,MCCONE,30,055,187,0.327,154,0.141,-33,-0.186
MONTANA,MEAGHER,30,059,247,0.254,193,0.198,-54,-0.056
MONTANA,MINERAL,30,061,542,0.295,519,0.258,-23,-0.037
MONTANA,MISSOULA,30,063,25598,0.515,31543,0.519,5945,0.004
MONTANA,MUSSELSHELL,30,065,538,0.240,332,0.136,-206,-0.104
MONTANA,PARK,30,067,3199,0.389,3595,0.384,396,-0.005
MONTANA,PETROLEUM,30,069,55,0.188,30,0.093,-25,-0.095
MONTANA,PHILLIPS,30,071,274,0.205,318,0.146,44,-0.059
MONTANA,PONDERA,30,073,956,0.334,738,0.271,-218,-0.063
MONTANA,POWDERRIVER,30,075,154,0.150,127,0.121,-27,-0.029
MONTANA,POWELL,30,077,751,0.269,551,0.197,-200,-0.072
MONTANA,PRAIRIE,30,079,181,0.246,100,0.145,-81,-0.101
MONTANA,RAVALLI,30,081,6128,0.310,6223,0.276,95,-0.034
MONTANA,RICHLAND,30,083,1120,0.260,671,0.138,-449,-0.122
MONTANA,ROOSEVELT,30,085,2193,0.545,1560,0.427,-633,-0.118
MONTANA,ROSEBUD,30,087,1520,0.424,987,0.286,-533,-0.138
MONTANA,SANDERS,30,089,1501,0.291,1218,0.205,-283,-0.086
MONTANA,SHERIDAN,30,091,845,0.415,477,0.260,-368,-0.155
MONTANA,SILVERBOW,30,093,5096,0.575,8619,0.524,3523,-0.050
MONTANA,STILLWATER,30,095,966,0.247,908,0.186,-58,-0.061
MONTANA,SWEETGRASS,30,097,292,0.226,402,0.191,110,-0.035
MONTANA,TETON,30,099,1047,0.312,808,0.253,-239,-0.059
MONTANA,TOOLE,30,101,690,0.299,402,0.197,-288,-0.102
MONTANA,TREASURE,30,103,121,0.251,59,0.133,-62,-0.118
MONTANA,VALLEY,30,105,1429,0.356,886,0.228,-543,-0.128
MONTANA,WHEATLAND,30,107,250,0.254,179,0.189,-71,-0.065
MONTANA,WIBAUX,30,109,144,0.257,55,0.102,-89,-0.155
MONTANA,YELLOWSTONE,30,111,24101,0.364,22171,0.315,-1930,-0.049
NEBRASKA,ADAMS,31,001,3791,0.285,3302,0.244,-489,-0.041
NEBRASKA,ANTELOPE,31,003,613,0.179,383,0.117,-230,-0.062
NEBRASKA,ARTHUR,31,005,24,0.090,17,0.062,-7,-0.028
NEBRASKA,BANNER,31,007,56,0.128,19,0.047,-37,-0.081
NEBRASKA,BLAINE,31,009,38,0.112,30,0.095,-8,-0.017
NEBRASKA,BOONE,31,011,546,0.189,414,0.143,-132,-0.046
NEBRASKA,BOXBUTTE,31,013,1657,0.322,965,0.196,-692,-0.126
NEBRASKA,BOYD,31,015,228,0.199,128,0.111,-100,-0.088
NEBRASKA,BROWN,31,017,268,0.155,153,0.096,-115,-0.059
NEBRASKA,BUFFALO,31,019,4100,0.220,4763,0.225,663,0.005
NEBRASKA,BURT,31,021,1272,0.347,930,0.261,-342,-0.086
NEBRASKA,BUTLER,31,023,1068,0.256,691,0.174,-377,-0.082
NEBRASKA,CASS,31,025,3619,0.314,3484,0.269,-135,-0.045
NEBRASKA,CEDAR,31,027,1083,0.239,571,0.129,-512,-0.110
NEBRASKA,CHASE,31,029,302,0.153,171,0.090,-131,-0.063
NEBRASKA,CHERRY,31,031,483,0.159,317,0.102,-166,-0.057
NEBRASKA,CHEYENNE,31,033,893,0.188,711,0.151,-182,-0.037
NEBRASKA,CLAY,31,035,743,0.223,477,0.156,-266,-0.067
NEBRASKA,COLFAX,31,037,990,0.273,859,0.267,-131,-0.006
NEBRASKA,CUMING,31,039,966,0.222,719,0.176,-247,-0.046
NEBRASKA,CUSTER,31,041,1040,0.185,641,0.113,-399,-0.072
NEBRASKA,DAKOTA,31,043,3027,0.458,2314,0.369,-713,-0.089
NEBRASKA,DAWES,31,045,1119,0.280,801,0.218,-318,-0.062
NEBRASKA,DAWSON,31,047,1728,0.217,2136,0.247,408,0.030
NEBRASKA,DEUEL,31,049,222,0.211,120,0.122,-102,-0.089
NEBRASKA,DIXON,31,051,938,0.312,556,0.200,-382,-0.112
NEBRASKA,DODGE,31,053,5250,0.325,4544,0.293,-706,-0.032
NEBRASKA,DOUGLAS,31,055,83330,0.402,113798,0.473,30468,0.071
NEBRASKA,DUNDY,31,057,186,0.177,89,0.093,-97,-0.084
NEBRASKA,FILLMORE,31,059,828,0.259,613,0.208,-215,-0.051
NEBRASKA,FRANKLIN,31,061,412,0.240,250,0.149,-162,-0.091
NEBRASKA,FRONTIER,31,063,275,0.187,161,0.121,-114,-0.066
NEBRASKA,FURNAS,31,065,492,0.199,304,0.130,-188,-0.069
NEBRASKA,GAGE,31,067,3655,0.352,2935,0.292,-720,-0.060
NEBRASKA,GARDEN,31,069,201,0.170,153,0.142,-48,-0.028
NEBRASKA,GARFIELD,31,071,196,0.193,121,0.123,-75,-0.070
NEBRASKA,GOSPER,31,073,222,0.198,166,0.164,-56,-0.034
NEBRASKA,GRANT,31,075,41,0.104,20,0.049,-21,-0.055
NEBRASKA,GREELEY,31,077,361,0.289,210,0.179,-151,-0.110
NEBRASKA,HALL,31,079,6228,0.294,6282,0.285,54,-0.009
NEBRASKA,HAMILTON,31,081,1012,0.208,878,0.175,-134,-0.033
NEBRASKA,HARLAN,31,083,398,0.210,254,0.139,-144,-0.071
NEBRASKA,HAYES,31,085,66,0.110,30,0.058,-36,-0.052
NEBRASKA,HITCHCOCK,31,087,296,0.199,161,0.110,-135,-0.089
NEBRASKA,HOLT,31,089,894,0.173,531,0.104,-363,-0.069
NEBRASKA,HOOKER,31,091,64,0.139,40,0.096,-24,-0.043
NEBRASKA,HOWARD,31,093,900,0.302,544,0.182,-356,-0.120
NEBRASKA,JEFFERSON,31,095,1352,0.337,837,0.240,-515,-0.097
NEBRASKA,JOHNSON,31,097,885,0.370,563,0.270,-322,-0.100
NEBRASKA,KEARNEY,31,099,707,0.209,550,0.167,-157,-0.042
NEBRASKA,KEITH,31,101,743,0.180,571,0.142,-172,-0.038
NEBRASKA,KEYAPAHA,31,103,98,0.179,40,0.077,-58,-0.102
NEBRASKA,KIMBALL,31,105,366,0.195,230,0.137,-136,-0.058
NEBRASKA,KNOX,31,107,1086,0.258,720,0.175,-366,-0.083
NEBRASKA,LANCASTER,31,109,52747,0.424,61898,0.454,9151,0.030
NEBRASKA,LINCOLN,31,111,4905,0.303,2913,0.181,-1992,-0.122
NEBRASKA,LOGAN,31,113,67,0.156,32,0.071,-35,-0.085
NEBRASKA,LOUP,31,115,68,0.176,48,0.125,-20,-0.051
NEBRASKA,MADISON,31,119,2934,0.208,2711,0.189,-223,-0.019
NEBRASKA,MCPHERSON,31,117,49,0.157,14,0.049,-35,-0.108
NEBRASKA,MERRICK,31,121,833,0.228,602,0.159,-231,-0.069
NEBRASKA,MORRILL,31,123,495,0.216,284,0.129,-211,-0.087
NEBRASKA,NANCE,31,125,459,0.265,281,0.173,-178,-0.092
NEBRASKA,NEMAHA,31,127,1066,0.287,785,0.248,-281,-0.039
NEBRASKA,NUCKOLLS,31,129,541,0.219,353,0.160,-188,-0.059
NEBRASKA,OTOE,31,131,2275,0.308,2025,0.272,-250,-0.036
NEBRASKA,PAWNEE,31,133,481,0.324,279,0.210,-202,-0.114
NEBRASKA,PERKINS,31,135,262,0.168,161,0.111,-101,-0.057
NEBRASKA,PHELPS,31,137,830,0.175,572,0.122,-258,-0.053
NEBRASKA,PIERCE,31,139,546,0.161,382,0.105,-164,-0.056
NEBRASKA,PLATTE,31,141,2657,0.190,2646,0.183,-11,-0.007
NEBRASKA,POLK,31,143,549,0.201,413,0.160,-136,-0.041
NEBRASKA,REDWILLOW,31,145,1055,0.201,645,0.125,-410,-0.076
NEBRASKA,RICHARDSON,31,147,1297,0.303,818,0.215,-479,-0.088
NEBRASKA,ROCK,31,149,130,0.147,70,0.088,-60,-0.059
NEBRASKA,SALINE,31,151,2420,0.435,1733,0.337,-687,-0.098
NEBRASKA,SARPY,31,153,17455,0.299,28033,0.348,10578,0.049
NEBRASKA,SAUNDERS,31,155,2884,0.304,2523,0.232,-361,-0.072
NEBRASKA,SCOTTSBLUFF,31,157,3843,0.267,3207,0.224,-636,-0.043
NEBRASKA,SEWARD,31,159,2114,0.279,1875,0.237,-239,-0.042
NEBRASKA,SHERIDAN,31,161,430,0.165,287,0.110,-143,-0.055
NEBRASKA,SHERMAN,31,163,541,0.329,340,0.216,-201,-0.113
NEBRASKA,SIOUX,31,165,123,0.152,81,0.110,-42,-0.042
NEBRASKA,STANTON,31,167,559,0.204,417,0.149,-142,-0.055
NEBRASKA,THAYER,31,169,764,0.265,499,0.186,-265,-0.079
NEBRASKA,THOMAS,31,171,60,0.135,30,0.076,-30,-0.059
NEBRASKA,THURSTON,31,173,1212,0.508,919,0.440,-293,-0.068
NEBRASKA,VALLEY,31,175,564,0.236,339,0.154,-225,-0.082
NEBRASKA,WASHINGTON,31,177,2754,0.277,2623,0.242,-131,-0.035
NEBRASKA,WAYNE,31,179,1059,0.259,835,0.221,-224,-0.038
NEBRASKA,WEBSTER,31,181,557,0.278,306,0.179,-251,-0.099
NEBRASKA,WHEELER,31,183,81,0.179,62,0.133,-19,-0.046
NEBRASKA,YORK,31,185,1304,0.192,1186,0.186,-118,-0.006
NEVADA,ELKO,32,007,3050,0.199,3401,0.183,351,-0.016
NEVADA,LANDER,32,015,414,0.202,403,0.167,-11,-0.035
NEVADA,EUREKA,32,011,144,0.195,74,0.087,-70,-0.108
NEVADA,LINCOLN,32,017,418,0.204,285,0.134,-133,-0.070
NEVADA,ESMERALDA,32,009,99,0.206,65,0.154,-34,-0.052
NEVADA,HUMBOLDT,32,013,1361,0.254,1386,0.215,25,-0.039
NEVADA,CHURCHILL,32,001,2705,0.264,2210,0.202,-495,-0.062
NEVADA,PERSHING,32,027,538,0.281,430,0.217,-108,-0.064
NEVADA,WHITEPINE,32,033,1082,0.285,707,0.187,-375,-0.098
NEVADA,LYON,32,019,5637,0.329,6146,0.259,509,-0.070
NEVADA,DOUGLAS,32,005,8275,0.346,8454,0.303,179,-0.043
NEVADA,NYE,32,023,5616,0.387,5094,0.260,-522,-0.127
NEVADA,STOREY,32,029,871,0.402,752,0.294,-119,-0.108
NEVADA,MINERAL,32,021,931,0.400,637,0.319,-294,-0.081
NEVADA,CARSONCITY,32,510,9441,0.409,9610,0.384,169,-0.025
NEVADA,WASHOE,32,031,74841,0.470,97379,0.464,22538,-0.006
NEVADA,CLARK,32,003,281767,0.517,402227,0.524,120460,0.007
NEW-HAMPSHIRE,CHESHIRE,33,005,24438,0.591,22064,0.527,-2374,-0.064
NEW-HAMPSHIRE,GRAFTON,33,009,26180,0.557,28510,0.557,2330,0.000
NEW-HAMPSHIRE,STRAFFORD,33,017,32942,0.556,34894,0.506,1952,-0.050
NEW-HAMPSHIRE,SULLIVAN,33,019,11434,0.524,10210,0.450,-1224,-0.074
NEW-HAMPSHIRE,MERRIMACK,33,013,39975,0.522,40198,0.481,223,-0.041
NEW-HAMPSHIRE,COOS,33,007,8585,0.507,6563,0.420,-2022,-0.087
NEW-HAMPSHIRE,HILLSBOROUGH,33,011,94121,0.482,99589,0.465,5468,-0.017
NEW-HAMPSHIRE,ROCKINGHAM,33,015,75437,0.475,79994,0.441,4557,-0.034
NEW-HAMPSHIRE,CARROLL,33,003,13319,0.472,12987,0.439,-332,-0.033
NEW-HAMPSHIRE,BELKNAP,33,001,14080,0.436,13517,0.386,-563,-0.050
NEW-JERSEY,ATLANTIC,34,001,55746,0.525,60924,0.516,5178,-0.009
NEW-JERSEY,BERGEN,34,003,207666,0.519,231211,0.548,23545,0.029
NEW-JERSEY,BURLINGTON,34,005,110411,0.531,121725,0.550,11314,0.019
NEW-JERSEY,CAMDEN,34,007,137765,0.624,146717,0.641,8952,0.017
NEW-JERSEY,CAPEMAY,34,009,21475,0.423,18750,0.381,-2725,-0.042
NEW-JERSEY,CUMBERLAND,34,011,27875,0.524,27771,0.511,-104,-0.013
NEW-JERSEY,ESSEX,34,013,203681,0.704,240837,0.770,37156,0.066
NEW-JERSEY,GLOUCESTER,34,015,66835,0.522,66870,0.473,35,-0.049
NEW-JERSEY,HUDSON,34,017,127447,0.673,163917,0.743,36470,0.070
NEW-JERSEY,HUNTERDON,34,019,26050,0.391,28898,0.403,2848,0.012
NEW-JERSEY,MERCER,34,021,91580,0.613,104775,0.663,13195,0.050
NEW-JERSEY,MIDDLESEX,34,023,166628,0.563,193044,0.588,26416,0.025
NEW-JERSEY,MONMOUTH,34,025,133773,0.446,137181,0.432,3408,-0.014
NEW-JERSEY,MORRIS,34,027,98066,0.417,115249,0.455,17183,0.038
NEW-JERSEY,OCEAN,34,029,99839,0.390,87150,0.315,-12689,-0.075
NEW-JERSEY,PASSAIC,34,031,94962,0.554,116759,0.595,21797,0.041
NEW-JERSEY,SALEM,34,033,13749,0.462,11904,0.399,-1845,-0.063
NEW-JERSEY,SOMERSET,34,035,66476,0.474,85689,0.545,19213,0.071
NEW-JERSEY,SUSSEX,34,037,23990,0.346,24212,0.322,222,-0.024
NEW-JERSEY,UNION,34,039,119372,0.587,147414,0.659,28042,0.072
NEW-JERSEY,WARREN,34,041,18044,0.374,17281,0.348,-763,-0.026
NEW-YORK,BRONX,36,005,283994,0.828,353646,0.885,69652,0.057
NEW-YORK,NEWYORK,36,061,526765,0.821,579013,0.866,52248,0.045
NEW-YORK,BROOKLYN,36,047,514973,0.749,640553,0.795,125580,0.046
NEW-YORK,QUEENS,36,081,433835,0.717,517220,0.754,83385,0.037
NEW-YORK,TOMPKINS,36,109,27229,0.642,28890,0.677,1661,0.035
NEW-YORK,ALBANY,36,001,89323,0.607,83077,0.594,-6246,-0.013
NEW-YORK,WESTCHESTER,36,119,229849,0.581,272926,0.649,43077,0.068
NEW-YORK,ERIE,36,029,251090,0.564,215456,0.509,-35634,-0.055
NEW-YORK,SAINTLAWRENCE,36,089,22857,0.547,16488,0.421,-6369,-0.126
NEW-YORK,ULSTER,36,111,47602,0.543,42101,0.517,-5501,-0.026
NEW-YORK,ONONDAGA,36,067,116381,0.542,112337,0.539,-4044,-0.003
NEW-YORK,NASSAU,36,059,323070,0.522,326088,0.512,3018,-0.010
NEW-YORK,CLINTON,36,019,17624,0.522,15059,0.469,-2565,-0.053
NEW-YORK,FRANKLIN,36,033,9543,0.521,7297,0.430,-2246,-0.091
NEW-YORK,SCHENECTADY,36,093,35971,0.518,33747,0.502,-2224,-0.016
NEW-YORK,COLUMBIA,36,021,15929,0.512,15284,0.495,-645,-0.017
NEW-YORK,MONROE,36,055,173497,0.506,188592,0.542,15095,0.036
NEW-YORK,BROOME,36,007,46281,0.504,39212,0.456,-7069,-0.048
NEW-YORK,RENSSELAER,36,083,36075,0.497,32717,0.457,-3358,-0.040
NEW-YORK,SUFFOLK,36,103,315909,0.495,303951,0.446,-11958,-0.049
NEW-YORK,NIAGARA,36,063,47602,0.493,35559,0.385,-12043,-0.108
NEW-YORK,ROCKLAND,36,087,64191,0.489,69342,0.513,5151,0.024
NEW-YORK,CAYUGA,36,011,17534,0.486,13522,0.408,-4012,-0.078
NEW-YORK,SULLIVAN,36,105,15034,0.486,12568,0.420,-2466,-0.066
NEW-YORK,OTSEGO,36,077,12723,0.477,10451,0.407,-2272,-0.070
NEW-YORK,DUTCHESS,36,027,58232,0.470,62261,0.476,4029,0.006
NEW-YORK,CORTLAND,36,023,10670,0.469,8771,0.433,-1899,-0.036
NEW-YORK,OSWEGO,36,075,24133,0.468,17095,0.355,-7038,-0.113
NEW-YORK,ESSEX,36,031,8768,0.459,7762,0.451,-1006,-0.008
NEW-YORK,SARATOGA,36,091,48730,0.456,50913,0.446,2183,-0.010
NEW-YORK,SENECA,36,099,6979,0.455,5697,0.408,-1282,-0.047
NEW-YORK,CHAUTAUQUA,36,013,27257,0.447,19091,0.352,-8166,-0.095
NEW-YORK,MONTGOMERY,36,057,9449,0.445,6595,0.346,-2854,-0.099
NEW-YORK,ORANGE,36,071,63394,0.438,68278,0.449,4884,0.011
NEW-YORK,CHEMUNG,36,015,17080,0.437,13757,0.381,-3323,-0.056
NEW-YORK,CHENANGO,36,017,9277,0.435,6775,0.336,-2502,-0.099
NEW-YORK,JEFFERSON,36,045,16860,0.435,13809,0.361,-3051,-0.074
NEW-YORK,MADISON,36,053,13121,0.433,11667,0.388,-1454,-0.045
NEW-YORK,WARREN,36,113,13405,0.432,13091,0.417,-314,-0.015
NEW-YORK,ONEIDA,36,065,40792,0.428,33743,0.371,-7049,-0.057
NEW-YORK,RICHMOND,36,085,68448,0.427,74143,0.410,5695,-0.017
NEW-YORK,WASHINGTON,36,115,10624,0.423,9098,0.371,-1526,-0.052
NEW-YORK,ONTARIO,36,069,21166,0.422,22233,0.425,1067,0.003
NEW-YORK,PUTNAM,36,079,19575,0.420,19366,0.399,-209,-0.021
NEW-YORK,FULTON,36,035,9202,0.414,6496,0.306,-2706,-0.108
NEW-YORK,DELAWARE,36,025,8724,0.412,6627,0.335,-2097,-0.077
NEW-YORK,HERKIMER,36,043,11675,0.412,8083,0.308,-3592,-0.104
NEW-YORK,TIOGA,36,107,9694,0.406,7526,0.338,-2168,-0.068
NEW-YORK,SCHUYLER,36,097,3445,0.401,3091,0.352,-354,-0.049
NEW-YORK,GREENE,36,039,8933,0.399,7405,0.336,-1528,-0.063
NEW-YORK,LEWIS,36,049,4546,0.399,3146,0.278,-1400,-0.121
NEW-YORK,CATTARAUGUS,36,009,13514,0.394,9497,0.305,-4017,-0.089
NEW-YORK,YATES,36,123,4205,0.393,3659,0.364,-546,-0.029
NEW-YORK,SCHOHARIE,36,095,5630,0.387,4240,0.302,-1390,-0.085
NEW-YORK,LIVINGSTON,36,051,11504,0.384,10697,0.356,-807,-0.028
NEW-YORK,WAYNE,36,117,15709,0.381,13473,0.339,-2236,-0.042
NEW-YORK,GENESEE,36,037,10331,0.375,7650,0.289,-2681,-0.086
NEW-YORK,ORLEANS,36,073,5959,0.360,4470,0.273,-1489,-0.087
NEW-YORK,STEUBEN,36,101,14523,0.343,12526,0.298,-1997,-0.045
NEW-YORK,ALLEGANY,36,003,6566,0.341,4882,0.261,-1684,-0.080
NEW-YORK,WYOMING,36,121,6134,0.338,3904,0.226,-2230,-0.112
NEW-YORK,HAMILTON,36,041,1145,0.310,949,0.294,-196,-0.016
NORTH-CAROLINA,ALAMANCE,37,001,20686,0.382,29833,0.419,9147,0.037
NORTH-CAROLINA,ALEXANDER,37,003,4618,0.296,3767,0.206,-851,-0.090
NORTH-CAROLINA,ALLEGHANY,37,005,1922,0.398,1306,0.246,-616,-0.152
NORTH-CAROLINA,ANSON,37,007,5413,0.587,5859,0.556,446,-0.031
NORTH-CAROLINA,ASHE,37,009,4477,0.379,3500,0.261,-977,-0.118
NORTH-CAROLINA,AVERY,37,011,1805,0.240,1689,0.205,-116,-0.035
NORTH-CAROLINA,BEAUFORT,37,013,7025,0.360,8764,0.366,1739,0.006
NORTH-CAROLINA,BERTIE,37,015,4938,0.615,5778,0.618,840,0.003
NORTH-CAROLINA,BLADEN,37,017,6109,0.496,7058,0.444,949,-0.052
NORTH-CAROLINA,BRUNSWICK,37,019,14903,0.392,23282,0.341,8379,-0.051
NORTH-CAROLINA,BUNCOMBE,37,021,51868,0.494,75452,0.543,23584,0.049
NORTH-CAROLINA,BURKE,37,023,11728,0.381,11251,0.289,-477,-0.092
NORTH-CAROLINA,CABARRUS,37,025,19803,0.326,35521,0.381,15718,0.055
NORTH-CAROLINA,CALDWELL,37,027,9999,0.319,8425,0.232,-1574,-0.087
NORTH-CAROLINA,CAMDEN,37,029,1339,0.350,1274,0.254,-65,-0.096
NORTH-CAROLINA,CARTERET,37,031,7732,0.302,9939,0.263,2207,-0.039
NORTH-CAROLINA,CASWELL,37,033,4539,0.481,4792,0.433,253,-0.048
NORTH-CAROLINA,CATAWBA,37,035,18858,0.321,21216,0.293,2358,-0.028
NORTH-CAROLINA,CHATHAM,37,037,12897,0.498,21065,0.529,8168,0.031
NORTH-CAROLINA,CHEROKEE,37,039,3635,0.325,2860,0.202,-775,-0.123
NORTH-CAROLINA,CHOWAN,37,041,2406,0.447,2992,0.414,586,-0.033
NORTH-CAROLINA,CLAY,37,043,1628,0.335,1367,0.227,-261,-0.108
NORTH-CAROLINA,CLEVELAND,37,045,14215,0.383,14964,0.335,749,-0.048
NORTH-CAROLINA,COLUMBUS,37,047,10343,0.488,9063,0.382,-1280,-0.106
NORTH-CAROLINA,CRAVEN,37,049,14019,0.371,17630,0.375,3611,0.004
NORTH-CAROLINA,CUMBERLAND,37,051,45788,0.481,71605,0.562,25817,0.081
NORTH-CAROLINA,CURRITUCK,37,053,2909,0.324,2913,0.230,4,-0.094
NORTH-CAROLINA,DARE,37,055,6136,0.395,7222,0.368,1086,-0.027
NORTH-CAROLINA,DAVIDSON,37,057,17191,0.289,18109,0.242,918,-0.047
NORTH-CAROLINA,DAVIE,37,059,4233,0.254,5270,0.242,1037,-0.012
NORTH-CAROLINA,DUPLIN,37,061,6923,0.417,8283,0.397,1360,-0.020
NORTH-CAROLINA,DURHAM,37,063,74524,0.680,121250,0.777,46726,0.097
NORTH-CAROLINA,EDGECOMBE,37,065,12877,0.611,16224,0.652,3347,0.041
NORTH-CAROLINA,FORSYTH,37,067,63340,0.455,94464,0.530,31124,0.075
NORTH-CAROLINA,FRANKLIN,37,069,9286,0.444,12874,0.424,3588,-0.020
NORTH-CAROLINA,GASTON,37,071,20254,0.318,31177,0.323,10923,0.005
NORTH-CAROLINA,GATES,37,073,2121,0.523,2385,0.442,264,-0.081
NORTH-CAROLINA,GRAHAM,37,075,1272,0.319,768,0.184,-504,-0.135
NORTH-CAROLINA,GRANVILLE,37,077,9057,0.487,12909,0.472,3852,-0.015
NORTH-CAROLINA,GREENE,37,079,2665,0.412,3605,0.445,940,0.033
NORTH-CAROLINA,GUILFORD,37,081,100042,0.502,149248,0.580,49206,0.078
NORTH-CAROLINA,HALIFAX,37,083,11528,0.587,15748,0.626,4220,0.039
NORTH-CAROLINA,HARNETT,37,085,11563,0.355,16737,0.363,5174,0.008
NORTH-CAROLINA,HAYWOOD,37,087,11237,0.433,10473,0.341,-764,-0.092
NORTH-CAROLINA,HENDERSON,37,089,15003,0.347,19827,0.341,4824,-0.006
NORTH-CAROLINA,HERTFORD,37,091,5141,0.632,6910,0.678,1769,0.046
NORTH-CAROLINA,HOKE,37,093,5794,0.523,9726,0.534,3932,0.011
NORTH-CAROLINA,HYDE,37,095,1048,0.457,965,0.419,-83,-0.038
NORTH-CAROLINA,IREDELL,37,097,18065,0.317,24734,0.300,6669,-0.017
NORTH-CAROLINA,JACKSON,37,099,6737,0.475,7713,0.412,976,-0.063
NORTH-CAROLINA,JOHNSTON,37,101,17266,0.318,28362,0.330,11096,0.012
NORTH-CAROLINA,JONES,37,103,1893,0.419,2065,0.402,172,-0.017
NORTH-CAROLINA,LEE,37,105,7657,0.392,10469,0.417,2812,0.025
NORTH-CAROLINA,LENOIR,37,107,10207,0.440,12634,0.471,2427,0.031
NORTH-CAROLINA,LINCOLN,37,109,9434,0.319,9897,0.247,463,-0.072
NORTH-CAROLINA,MCDOWELL,37,111,5330,0.333,4667,0.235,-663,-0.098
NORTH-CAROLINA,MACON,37,113,5489,0.365,4876,0.275,-613,-0.090
NORTH-CAROLINA,MADISON,37,115,4234,0.447,3926,0.348,-308,-0.099
NORTH-CAROLINA,MARTIN,37,117,5102,0.488,5846,0.489,744,0.001
NORTH-CAROLINA,MECKLENBURG,37,119,166828,0.516,294562,0.623,127734,0.107
NORTH-CAROLINA,MITCHELL,37,121,2080,0.267,1596,0.197,-484,-0.070
NORTH-CAROLINA,MONTGOMERY,37,123,4313,0.428,4150,0.360,-163,-0.068
NORTH-CAROLINA,MOORE,37,125,13555,0.353,16329,0.335,2774,-0.018
NORTH-CAROLINA,NASH,37,127,15693,0.417,23235,0.487,7542,0.070
NORTH-CAROLINA,NEWHANOVER,37,129,35572,0.438,50979,0.456,15407,0.018
NORTH-CAROLINA,NORTHAMPTON,37,131,5584,0.637,6144,0.624,560,-0.013
NORTH-CAROLINA,ONSLOW,37,133,11250,0.302,17514,0.307,6264,0.005
NORTH-CAROLINA,ORANGE,37,135,42910,0.669,59923,0.728,17013,0.059
NORTH-CAROLINA,PAMLICO,37,137,2335,0.387,2448,0.356,113,-0.031
NORTH-CAROLINA,PASQUOTANK,37,139,6984,0.512,8615,0.495,1631,-0.017
NORTH-CAROLINA,PENDER,37,141,6999,0.410,9354,0.335,2355,-0.075
NORTH-CAROLINA,PERQUIMANS,37,143,1971,0.398,2319,0.346,348,-0.052
NORTH-CAROLINA,PERSON,37,145,6198,0.407,7833,0.399,1635,-0.008
NORTH-CAROLINA,PITT,37,147,24924,0.465,41824,0.519,16900,0.054
NORTH-CAROLINA,POLK,37,149,3787,0.420,3735,0.342,-52,-0.078
NORTH-CAROLINA,RANDOLPH,37,151,12966,0.255,13194,0.204,228,-0.051
NORTH-CAROLINA,RICHMOND,37,153,8383,0.519,8501,0.440,118,-0.079
NORTH-CAROLINA,ROBESON,37,155,17868,0.528,19016,0.465,1148,-0.063
NORTH-CAROLINA,ROCKINGHAM,37,157,14430,0.386,14228,0.337,-202,-0.049
NORTH-CAROLINA,ROWAN,37,159,16735,0.323,19400,0.301,2665,-0.022
NORTH-CAROLINA,RUTHERFORD,37,161,8184,0.332,7512,0.248,-672,-0.084
NORTH-CAROLINA,SAMPSON,37,163,9649,0.433,10547,0.407,898,-0.026
NORTH-CAROLINA,SCOTLAND,37,165,6386,0.553,7319,0.525,933,-0.028
NORTH-CAROLINA,STANLY,37,167,7650,0.299,7094,0.237,-556,-0.062
NORTH-CAROLINA,STOKES,37,169,5767,0.297,4665,0.207,-1102,-0.090
NORTH-CAROLINA,SURRY,37,171,8304,0.319,7488,0.233,-816,-0.086
NORTH-CAROLINA,SWAIN,37,173,2419,0.480,2196,0.359,-223,-0.121
NORTH-CAROLINA,TRANSYLVANIA,37,175,6097,0.391,6558,0.367,461,-0.024
NORTH-CAROLINA,TYRRELL,37,177,731,0.460,720,0.414,-11,-0.046
NORTH-CAROLINA,UNION,37,179,17974,0.295,34337,0.325,16363,0.030
NORTH-CAROLINA,VANCE,37,181,8762,0.559,12229,0.612,3467,0.053
NORTH-CAROLINA,WAKE,37,183,169909,0.487,302736,0.574,132827,0.087
NORTH-CAROLINA,WARREN,37,185,5171,0.644,6413,0.652,1242,0.008
NORTH-CAROLINA,WASHINGTON,37,187,2969,0.543,3510,0.569,541,0.026
NORTH-CAROLINA,WATAUGA,37,189,11232,0.467,14138,0.472,2906,0.005
NORTH-CAROLINA,WAYNE,37,191,15076,0.376,21770,0.429,6694,0.053
NORTH-CAROLINA,WILKES,37,193,7862,0.290,6638,0.212,-1224,-0.078
NORTH-CAROLINA,WILSON,37,195,14206,0.465,19663,0.516,5457,0.051
NORTH-CAROLINA,YADKIN,37,197,3451,0.225,3160,0.179,-291,-0.046
NORTH-CAROLINA,YANCEY,37,199,4434,0.470,3196,0.321,-1238,-0.149
NORTH-DAKOTA,ADAMS,38,001,351,0.273,216,0.177,-135,-0.096
NORTH-DAKOTA,BARNES,38,003,2175,0.376,1597,0.299,-578,-0.077
NORTH-DAKOTA,BENSON,38,005,1195,0.533,842,0.419,-353,-0.114
NORTH-DAKOTA,BILLINGS,38,007,99,0.176,59,0.098,-40,-0.078
NORTH-DAKOTA,BOTTINEAU,38,009,1163,0.317,736,0.211,-427,-0.106
NORTH-DAKOTA,BOWMAN,38,011,397,0.231,227,0.127,-170,-0.104
NORTH-DAKOTA,BURKE,38,013,334,0.287,119,0.113,-215,-0.174
NORTH-DAKOTA,BURLEIGH,38,015,11511,0.299,10881,0.227,-630,-0.072
NORTH-DAKOTA,CASS,38,017,25927,0.390,31361,0.388,5434,-0.002
NORTH-DAKOTA,CAVALIER,38,019,373,0.352,476,0.237,103,-0.115
NORTH-DAKOTA,DICKEY,38,021,881,0.313,554,0.230,-327,-0.083
NORTH-DAKOTA,DIVIDE,38,023,483,0.383,245,0.201,-238,-0.182
NORTH-DAKOTA,DUNN,38,025,569,0.322,358,0.160,-211,-0.162
NORTH-DAKOTA,EDDY,38,027,533,0.440,355,0.288,-178,-0.152
NORTH-DAKOTA,EMMONS,38,029,342,0.299,215,0.109,-127,-0.190
NORTH-DAKOTA,FOSTER,38,031,518,0.294,347,0.202,-171,-0.092
NORTH-DAKOTA,GOLDENVALLEY,38,033,194,0.210,99,0.103,-95,-0.107
NORTH-DAKOTA,GRANDFORKS,38,035,12611,0.415,10851,0.357,-1760,-0.058
NORTH-DAKOTA,GRANT,38,037,264,0.213,185,0.134,-79,-0.079
NORTH-DAKOTA,GRIGGS,38,039,504,0.351,298,0.236,-206,-0.115
NORTH-DAKOTA,HETTINGER,38,041,403,0.271,168,0.130,-235,-0.141
NORTH-DAKOTA,KIDDER,38,043,433,0.317,179,0.130,-254,-0.186
NORTH-DAKOTA,LAMOURE,38,045,712,0.305,502,0.233,-210,-0.072
NORTH-DAKOTA,LOGAN,38,047,261,0.232,114,0.107,-147,-0.125
NORTH-DAKOTA,MCHENRY,38,049,1028,0.365,490,0.174,-538,-0.191
NORTH-DAKOTA,MCINTOSH,38,051,437,0.254,235,0.163,-202,-0.091
NORTH-DAKOTA,MCKENZIE,38,053,840,0.306,698,0.149,-142,-0.158
NORTH-DAKOTA,MCLEAN,38,055,1651,0.350,1081,0.203,-570,-0.147
NORTH-DAKOTA,MERCER,38,057,1243,0.270,621,0.133,-622,-0.137
NORTH-DAKOTA,MORTON,38,059,4041,0.322,3080,0.195,-961,-0.127
NORTH-DAKOTA,MOUNTRAIL,38,061,1463,0.484,1220,0.297,-243,-0.187
NORTH-DAKOTA,NELSON,38,063,778,0.405,536,0.312,-242,-0.093
NORTH-DAKOTA,OLIVER,38,065,309,0.277,119,0.117,-190,-0.160
NORTH-DAKOTA,PEMBINA,38,067,1320,0.343,681,0.216,-639,-0.127
NORTH-DAKOTA,PIERCE,38,069,684,0.313,431,0.208,-253,-0.105
NORTH-DAKOTA,RAMSEY,38,071,1884,0.385,1505,0.284,-379,-0.101
NORTH-DAKOTA,RANSOM,38,073,1197,0.461,838,0.355,-359,-0.106
NORTH-DAKOTA,RENVILLE,38,075,494,0.339,201,0.155,-293,-0.184
NORTH-DAKOTA,RICHLAND,38,077,2820,0.344,2064,0.272,-756,-0.072
NORTH-DAKOTA,ROLETTE,38,079,2559,0.634,2099,0.559,-460,-0.075
NORTH-DAKOTA,SARGENT,38,081,1017,0.464,694,0.348,-323,-0.116
NORTH-DAKOTA,SHERIDAN,38,083,199,0.211,95,0.121,-104,-0.090
NORTH-DAKOTA,SIOUX,38,085,801,0.705,758,0.615,-43,-0.090
NORTH-DAKOTA,SLOPE,38,087,89,0.202,43,0.100,-46,-0.102
NORTH-DAKOTA,STARK,38,089,3001,0.290,1753,0.142,-1248,-0.148
NORTH-DAKOTA,STEELE,38,091,614,0.508,361,0.361,-253,-0.147
NORTH-DAKOTA,STUTSMAN,38,093,3429,0.340,2498,0.246,-931,-0.094
NORTH-DAKOTA,TOWNER,38,095,606,0.436,305,0.264,-301,-0.172
NORTH-DAKOTA,TRAILL,38,097,1650,0.389,1241,0.316,-409,-0.073
NORTH-DAKOTA,WALSH,38,099,1905,0.368,1167,0.252,-738,-0.116
NORTH-DAKOTA,WARD,38,101,8223,0.322,5806,0.212,-2417,-0.110
NORTH-DAKOTA,WELLS,38,103,858,0.336,419,0.176,-439,-0.160
NORTH-DAKOTA,WILLIAMS,38,105,1975,0.275,1735,0.135,-240,-0.140
OHIO,ADAMS,39,001,4280,0.357,2326,0.204,-1954,-0.153
OHIO,ALLEN,39,003,16483,0.335,13294,0.288,-3189,-0.047
OHIO,ASHLAND,39,005,8555,0.343,5740,0.232,-2815,-0.111
OHIO,ASHTABULA,39,007,24061,0.530,15577,0.378,-8484,-0.152
OHIO,ATHENS,39,009,18997,0.632,16370,0.551,-2627,-0.081
OHIO,AUGLAIZE,39,011,5904,0.256,3980,0.167,-1924,-0.089
OHIO,BELMONT,39,013,17574,0.527,8785,0.280,-8789,-0.247
OHIO,BROWN,39,015,7140,0.359,4353,0.221,-2787,-0.138
OHIO,BUTLER,39,017,56234,0.337,58642,0.335,2408,-0.002
OHIO,CARROLL,39,019,6298,0.446,3154,0.240,-3144,-0.206
OHIO,CHAMPAIGN,39,021,6967,0.371,4594,0.252,-2373,-0.119
OHIO,CLARK,39,023,33534,0.487,23328,0.377,-10206,-0.110
OHIO,CLERMONT,39,025,25885,0.291,26715,0.267,830,-0.024
OHIO,CLINTON,39,027,5417,0.294,4066,0.217,-1351,-0.077
OHIO,COLUMBIANA,39,029,23426,0.474,12432,0.267,-10994,-0.207
OHIO,COSHOCTON,39,031,6878,0.423,4013,0.256,-2865,-0.167
OHIO,CRAWFORD,39,033,7773,0.357,4625,0.239,-3148,-0.118
OHIO,CUYAHOGA,39,035,448486,0.666,398271,0.654,-50215,-0.012
OHIO,DARKE,39,037,7849,0.298,4470,0.175,-3379,-0.123
OHIO,DEFIANCE,39,039,6975,0.377,5368,0.293,-1607,-0.084
OHIO,DELAWARE,39,041,27048,0.336,40872,0.387,13824,0.051
OHIO,ERIE,39,043,21408,0.534,16057,0.424,-5351,-0.110
OHIO,FAIRFIELD,39,045,24774,0.365,24881,0.338,107,-0.027
OHIO,FAYETTE,39,047,4334,0.369,2739,0.244,-1595,-0.125
OHIO,FRANKLIN,39,049,285800,0.544,351198,0.598,65398,0.054
OHIO,FULTON,39,051,8224,0.375,6069,0.284,-2155,-0.091
OHIO,GALLIA,39,053,5364,0.383,2628,0.202,-2736,-0.181
OHIO,GEAUGA,39,055,19840,0.394,17569,0.347,-2271,-0.047
OHIO,GREENE,39,057,30530,0.385,28943,0.349,-1587,-0.036
OHIO,GUERNSEY,39,059,7768,0.435,4359,0.262,-3409,-0.173
OHIO,HAMILTON,39,061,199499,0.471,215719,0.527,16220,0.056
OHIO,HANCOCK,39,063,10343,0.290,9609,0.265,-734,-0.025
OHIO,HARDIN,39,065,4889,0.365,2920,0.236,-1969,-0.129
OHIO,HARRISON,39,067,3780,0.466,1688,0.238,-2092,-0.228
OHIO,HENRY,39,069,5110,0.338,3756,0.267,-1354,-0.071
OHIO,HIGHLAND,39,071,6194,0.335,3773,0.203,-2421,-0.132
OHIO,HOCKING,39,073,6173,0.468,3775,0.292,-2398,-0.176
OHIO,HOLMES,39,075,2695,0.240,1788,0.161,-907,-0.079
OHIO,HURON,39,077,10585,0.414,7192,0.288,-3393,-0.126
OHIO,JACKSON,39,079,5699,0.398,3226,0.234,-2473,-0.164
OHIO,JEFFERSON,39,081,19019,0.523,9675,0.299,-9344,-0.224
OHIO,KNOX,39,083,9828,0.363,8171,0.282,-1657,-0.081
OHIO,LAKE,39,085,59049,0.485,46397,0.396,-12652,-0.089
OHIO,LAWRENCE,39,087,12111,0.437,6974,0.260,-5137,-0.177
OHIO,LICKING,39,089,30051,0.378,27376,0.327,-2675,-0.051
OHIO,LOGAN,39,091,6825,0.319,4647,0.214,-2178,-0.105
OHIO,LORAIN,39,093,78965,0.561,66949,0.476,-12016,-0.085
OHIO,LUCAS,39,095,132536,0.602,110833,0.557,-21703,-0.045
OHIO,MADISON,39,097,6200,0.356,4779,0.274,-1421,-0.082
OHIO,MAHONING,39,099,83069,0.626,57381,0.495,-25688,-0.131
OHIO,MARION,39,101,11930,0.408,7928,0.299,-4002,-0.109
OHIO,MEDINA,39,103,36264,0.427,32182,0.349,-4082,-0.078
OHIO,MEIGS,39,105,4437,0.412,2260,0.225,-2177,-0.187
OHIO,MERCER,39,107,5117,0.245,3384,0.155,-1733,-0.090
OHIO,MIAMI,39,109,17611,0.340,13120,0.247,-4491,-0.093
OHIO,MONROE,39,111,4243,0.549,1662,0.243,-2581,-0.306
OHIO,MONTGOMERY,39,113,142977,0.506,122016,0.470,-20961,-0.036
OHIO,MORGAN,39,115,2873,0.429,1736,0.268,-1137,-0.161
OHIO,MORROW,39,117,5775,0.354,3761,0.225,-2014,-0.129
OHIO,MUSKINGUM,39,119,16421,0.423,11123,0.299,-5298,-0.124
OHIO,NOBLE,39,121,2654,0.406,1221,0.202,-1433,-0.204
OHIO,OTTAWA,39,123,11114,0.478,8285,0.370,-2829,-0.108
OHIO,PAULDING,39,125,3610,0.365,2093,0.230,-1517,-0.135
OHIO,PERRY,39,127,7257,0.478,4138,0.274,-3119,-0.204
OHIO,PICKAWAY,39,129,8578,0.375,6529,0.262,-2049,-0.113
OHIO,PIKE,39,131,5989,0.476,3539,0.296,-2450,-0.180
OHIO,PORTAGE,39,133,40674,0.531,32397,0.422,-8277,-0.109
OHIO,PREBLE,39,135,7274,0.344,4325,0.209,-2949,-0.135
OHIO,PUTNAM,39,137,4392,0.233,2922,0.155,-1470,-0.078
OHIO,RICHLAND,39,139,24645,0.398,16085,0.290,-8560,-0.108
OHIO,ROSS,39,141,13977,0.441,10356,0.339,-3621,-0.102
OHIO,SANDUSKY,39,143,12653,0.437,9929,0.351,-2724,-0.086
OHIO,SCIOTO,39,145,16823,0.478,9132,0.295,-7691,-0.183
OHIO,SENECA,39,147,10958,0.406,7404,0.306,-3554,-0.100
OHIO,SHELBY,39,149,6534,0.286,4243,0.178,-2291,-0.108
OHIO,STARK,39,151,95338,0.506,68146,0.387,-27192,-0.119
OHIO,SUMMIT,39,153,156578,0.567,134256,0.516,-22322,-0.051
OHIO,TRUMBULL,39,155,66673,0.617,43014,0.445,-23659,-0.172
OHIO,TUSCARAWAS,39,157,18854,0.439,12188,0.293,-6666,-0.146
OHIO,UNION,39,159,6665,0.295,7718,0.279,1053,-0.016
OHIO,VANWERT,39,161,4094,0.276,2697,0.196,-1397,-0.080
OHIO,VINTON,39,163,2651,0.447,1351,0.244,-1300,-0.203
OHIO,WARREN,39,165,26043,0.276,33730,0.285,7687,0.009
OHIO,WASHINGTON,39,167,12475,0.414,8026,0.266,-4449,-0.148
OHIO,WAYNE,39,169,19786,0.382,15031,0.299,-4755,-0.083
OHIO,WILLIAMS,39,171,6481,0.348,4358,0.252,-2123,-0.096
OHIO,WOOD,39,173,29401,0.464,27318,0.421,-2083,-0.043
OHIO,WYANDOT,39,175,3707,0.336,2515,0.236,-1192,-0.100
OKLAHOMA,ADAIR,40,001,2560,0.340,1382,0.212,-1178,-0.128
OKLAHOMA,ALFALFA,40,003,470,0.180,216,0.096,-254,-0.084
OKLAHOMA,ATOKA,40,005,1946,0.380,795,0.158,-1151,-0.222
OKLAHOMA,BEAVER,40,007,297,0.120,176,0.078,-121,-0.042
OKLAHOMA,BECKHAM,40,009,1931,0.260,960,0.127,-971,-0.133
OKLAHOMA,BLAINE,40,011,1222,0.280,711,0.187,-511,-0.093
OKLAHOMA,BRYAN,40,013,5742,0.400,2804,0.203,-2938,-0.197
OKLAHOMA,CADDO,40,015,3916,0.380,2420,0.259,-1496,-0.121
OKLAHOMA,CANADIAN,40,017,9712,0.230,11674,0.211,1962,-0.019
OKLAHOMA,CARTER,40,019,6464,0.350,4002,0.216,-2462,-0.134
OKLAHOMA,CHEROKEE,40,021,8622,0.470,5456,0.331,-3166,-0.139
OKLAHOMA,CHOCTAW,40,023,2639,0.450,1067,0.197,-1572,-0.253
OKLAHOMA,CIMARRON,40,025,184,0.130,71,0.066,-113,-0.064
OKLAHOMA,CLEVELAND,40,027,33984,0.340,38829,0.355,4845,0.015
OKLAHOMA,COAL,40,029,1203,0.460,411,0.171,-792,-0.289
OKLAHOMA,COMANCHE,40,031,12020,0.360,11463,0.352,-557,-0.008
OKLAHOMA,COTTON,40,033,898,0.340,424,0.163,-474,-0.177
OKLAHOMA,CRAIG,40,035,2504,0.390,1252,0.216,-1252,-0.174
OKLAHOMA,CREEK,40,037,9927,0.350,5841,0.203,-4086,-0.147
OKLAHOMA,CUSTER,40,039,2801,0.260,2104,0.200,-697,-0.060
OKLAHOMA,DELAWARE,40,041,5591,0.360,3311,0.211,-2280,-0.149
OKLAHOMA,DEWEY,40,043,408,0.180,222,0.099,-186,-0.081
OKLAHOMA,ELLIS,40,045,395,0.190,155,0.085,-240,-0.105
OKLAHOMA,GARFIELD,40,047,5586,0.240,4397,0.203,-1189,-0.037
OKLAHOMA,GARVIN,40,049,3706,0.330,1855,0.176,-1851,-0.154
OKLAHOMA,GRADY,40,051,5969,0.300,3882,0.174,-2087,-0.126
OKLAHOMA,GRANT,40,053,571,0.230,288,0.131,-283,-0.099
OKLAHOMA,GREER,40,055,719,0.320,323,0.170,-396,-0.150
OKLAHOMA,HARMON,40,057,354,0.300,225,0.230,-129,-0.070
OKLAHOMA,HARPER,40,059,268,0.160,134,0.089,-134,-0.071
OKLAHOMA,HASKELL,40,061,2378,0.450,882,0.186,-1496,-0.264
OKLAHOMA,HUGHES,40,063,2286,0.430,961,0.212,-1325,-0.218
OKLAHOMA,JACKSON,40,065,2232,0.240,1473,0.189,-759,-0.051
OKLAHOMA,JEFFERSON,40,067,1057,0.410,365,0.155,-692,-0.255
OKLAHOMA,JOHNSTON,40,069,1711,0.390,786,0.196,-925,-0.194
OKLAHOMA,KAY,40,071,5956,0.300,3738,0.222,-2218,-0.078
OKLAHOMA,KINGFISHER,40,073,1022,0.150,786,0.128,-236,-0.022
OKLAHOMA,KIOWA,40,075,1413,0.350,767,0.220,-646,-0.130
OKLAHOMA,LATIMER,40,077,1945,0.430,797,0.196,-1148,-0.234
OKLAHOMA,LEFLORE,40,079,6740,0.390,3250,0.189,-3490,-0.201
OKLAHOMA,LINCOLN,40,081,4041,0.280,2430,0.173,-1611,-0.107
OKLAHOMA,LOGAN,40,083,4869,0.300,4248,0.224,-621,-0.076
OKLAHOMA,LOVE,40,085,1538,0.400,735,0.194,-803,-0.206
OKLAHOMA,MAJOR,40,093,537,0.150,310,0.091,-227,-0.059
OKLAHOMA,MARSHALL,40,095,2088,0.380,1096,0.200,-992,-0.180
OKLAHOMA,MAYES,40,097,6933,0.410,3423,0.218,-3510,-0.192
OKLAHOMA,MCCLAIN,40,087,3742,0.270,2894,0.172,-848,-0.098
OKLAHOMA,MCCURTAIN,40,089,3684,0.330,1802,0.168,-1882,-0.162
OKLAHOMA,MCINTOSH,40,091,4488,0.490,2123,0.267,-2365,-0.223
OKLAHOMA,MURRAY,40,099,2310,0.390,1087,0.197,-1223,-0.193
OKLAHOMA,MUSKOGEE,40,101,12585,0.450,7977,0.329,-4608,-0.121
OKLAHOMA,NOBLE,40,103,1335,0.250,901,0.185,-434,-0.065
OKLAHOMA,NOWATA,40,105,1659,0.370,742,0.175,-917,-0.195
OKLAHOMA,OKFUSKEE,40,107,1743,0.410,943,0.239,-800,-0.171
OKLAHOMA,OKLAHOMA,40,109,97283,0.360,112813,0.412,15530,0.052
OKLAHOMA,OKMULGEE,40,111,7367,0.470,4385,0.314,-2982,-0.156
OKLAHOMA,OSAGE,40,113,8068,0.410,5597,0.295,-2471,-0.115
OKLAHOMA,OTTAWA,40,115,5084,0.410,2584,0.242,-2500,-0.168
OKLAHOMA,PAWNEE,40,117,2563,0.370,1344,0.211,-1219,-0.159
OKLAHOMA,PAYNE,40,119,10101,0.340,8788,0.317,-1313,-0.023
OKLAHOMA,PITTSBURG,40,121,7452,0.400,3711,0.215,-3741,-0.185
OKLAHOMA,PONTOTOC,40,123,5165,0.350,3637,0.245,-1528,-0.105
OKLAHOMA,POTTAWATOMIE,40,125,8636,0.330,6015,0.236,-2621,-0.094
OKLAHOMA,PUSHMATAHA,40,127,1934,0.400,748,0.167,-1186,-0.233
OKLAHOMA,ROGER,40,129,382,0.220,151,0.086,-231,-0.134
OKLAHOMA,ROGERS,40,131,11917,0.320,7902,0.193,-4015,-0.127
OKLAHOMA,SEMINOLE,40,133,3648,0.390,2071,0.258,-1577,-0.132
OKLAHOMA,SEQUOYAH,40,135,5910,0.400,3061,0.212,-2849,-0.188
OKLAHOMA,STEPHENS,40,137,5514,0.290,3086,0.172,-2428,-0.118
OKLAHOMA,TEXAS,40,139,1016,0.160,858,0.148,-158,-0.012
OKLAHOMA,TILLMAN,40,141,1175,0.340,657,0.243,-518,-0.097
OKLAHOMA,TULSA,40,143,90204,0.360,87847,0.356,-2357,-0.004
OKLAHOMA,WAGONER,40,145,9157,0.320,6723,0.215,-2434,-0.105
OKLAHOMA,WASHINGTON,40,147,6862,0.290,5048,0.227,-1814,-0.063
OKLAHOMA,WASHITA,40,149,1340,0.270,588,0.127,-752,-0.143
OKLAHOMA,WOODS,40,151,930,0.230,522,0.142,-408,-0.088
OKLAHOMA,WOODWARD,40,153,1457,0.190,873,0.115,-584,-0.075
OREGON,BAKER,41,001,2616,0.290,1797,0.205,-819,-0.085
OREGON,BENTON,41,003,26514,0.580,29193,0.599,2679,0.019
OREGON,CLACKAMAS,41,005,95129,0.488,102095,0.477,6966,-0.011
OREGON,CLATSOP,41,007,10461,0.542,9252,0.471,-1209,-0.071
OREGON,COLUMBIA,41,009,12563,0.504,10167,0.382,-2396,-0.122
OREGON,COOS,41,011,14393,0.431,10448,0.334,-3945,-0.097
OREGON,CROOK,41,013,3024,0.301,2637,0.217,-387,-0.084
OREGON,CURRY,41,015,5220,0.408,4300,0.341,-920,-0.067
OREGON,DESCHUTES,41,017,31179,0.421,42444,0.431,11265,0.010
OREGON,DOUGLAS,41,019,18089,0.329,14096,0.263,-3993,-0.066
OREGON,GILLIAM,41,021,370,0.325,239,0.235,-131,-0.090
OREGON,GRANT,41,023,780,0.192,739,0.170,-41,-0.022
OREGON,HARNEY,41,025,839,0.227,683,0.172,-156,-0.055
OREGON,HOODRIVER,41,027,5587,0.567,6510,0.597,923,0.030
OREGON,JACKSON,41,029,44366,0.434,44447,0.407,81,-0.027
OREGON,JEFFERSON,41,031,3243,0.400,2980,0.315,-263,-0.085
OREGON,JOSEPHINE,41,033,15124,0.360,13453,0.302,-1671,-0.058
OREGON,KLAMATH,41,035,8264,0.262,7210,0.236,-1054,-0.026
OREGON,LAKE,41,037,802,0.205,639,0.163,-163,-0.042
OREGON,LANE,41,039,107769,0.580,102753,0.535,-5016,-0.045
OREGON,LINCOLN,41,041,13753,0.565,12501,0.495,-1252,-0.070
OREGON,LINN,41,043,19940,0.383,17995,0.306,-1945,-0.077
OREGON,MALHEUR,41,045,2577,0.238,2246,0.215,-331,-0.023
OREGON,MARION,41,047,57671,0.445,57788,0.422,117,-0.023
OREGON,MORROW,41,049,1361,0.328,1017,0.244,-344,-0.084
OREGON,MULTNOMAH,41,051,259585,0.716,292561,0.733,32976,0.017
OREGON,POLK,41,053,15484,0.436,16420,0.407,936,-0.029
OREGON,SHERMAN,41,055,390,0.353,202,0.199,-188,-0.154
OREGON,TILLAMOOK,41,057,6750,0.484,5768,0.418,-982,-0.066
OREGON,UMATILLA,41,059,8884,0.338,7673,0.278,-1211,-0.060
OREGON,UNION,41,061,4428,0.328,3249,0.251,-1179,-0.077
OREGON,WALLOWA,41,063,1269,0.281,1116,0.256,-153,-0.025
OREGON,WASCO,41,065,5691,0.474,4781,0.400,-910,-0.074
OREGON,WASHINGTON,41,067,121140,0.524,153251,0.569,32111,0.045
OREGON,WHEELER,41,069,245,0.278,155,0.189,-90,-0.089
OREGON,YAMHILL,41,071,17572,0.417,19301,0.396,1729,-0.021
PENNSYLVANIA,ADAMS,42,001,13764,0.326,14219,0.296,455,-0.030
PENNSYLVANIA,ALLEGHENY,42,003,368912,0.572,367617,0.559,-1295,-0.013
PENNSYLVANIA,ARMSTRONG,42,005,12025,0.387,7178,0.225,-4847,-0.162
PENNSYLVANIA,BEAVER,42,007,42146,0.511,32531,0.385,-9615,-0.126
PENNSYLVANIA,BEDFORD,42,009,6016,0.265,3645,0.154,-2371,-0.111
PENNSYLVANIA,BERKS,42,011,76309,0.464,78437,0.426,2128,-0.038
PENNSYLVANIA,BLAIR,42,013,18105,0.334,13958,0.252,-4147,-0.082
PENNSYLVANIA,BRADFORD,42,015,8590,0.335,6369,0.245,-2221,-0.090
PENNSYLVANIA,BUCKS,42,017,163438,0.511,167060,0.485,3622,-0.026
PENNSYLVANIA,BUTLER,42,019,30090,0.352,28584,0.292,-1506,-0.060
PENNSYLVANIA,CAMBRIA,42,021,32591,0.487,18867,0.297,-13724,-0.190
PENNSYLVANIA,CAMERON,42,023,794,0.330,531,0.243,-263,-0.087
PENNSYLVANIA,CARBON,42,025,12223,0.488,8936,0.308,-3287,-0.180
PENNSYLVANIA,CENTRE,42,027,30733,0.478,37088,0.480,6355,0.002
PENNSYLVANIA,CHESTER,42,029,109708,0.475,141682,0.519,31974,0.044
PENNSYLVANIA,CLARION,42,031,6049,0.352,4273,0.242,-1776,-0.110
PENNSYLVANIA,CLEARFIELD,42,033,13518,0.395,8200,0.237,-5318,-0.158
PENNSYLVANIA,CLINTON,42,035,5823,0.417,4744,0.306,-1079,-0.111
PENNSYLVANIA,COLUMBIA,42,037,10679,0.397,8934,0.313,-1745,-0.084
PENNSYLVANIA,CRAWFORD,42,039,16013,0.418,10971,0.290,-5042,-0.128
PENNSYLVANIA,CUMBERLAND,42,041,37928,0.358,47085,0.381,9157,0.023
PENNSYLVANIA,DAUPHIN,42,043,55299,0.456,64706,0.491,9407,0.035
PENNSYLVANIA,DELAWARE,42,045,162601,0.571,177402,0.593,14801,0.022
PENNSYLVANIA,ELK,42,047,6602,0.454,3853,0.265,-2749,-0.189
PENNSYLVANIA,ERIE,42,049,67921,0.539,58112,0.464,-9809,-0.075
PENNSYLVANIA,FAYETTE,42,051,29120,0.532,17946,0.334,-11174,-0.198
PENNSYLVANIA,FOREST,42,053,989,0.384,626,0.259,-363,-0.125
PENNSYLVANIA,FRANKLIN,42,055,16562,0.283,17465,0.248,903,-0.035
PENNSYLVANIA,FULTON,42,057,1475,0.235,912,0.134,-563,-0.101
PENNSYLVANIA,GREENE,42,059,7674,0.493,4482,0.282,-3192,-0.211
PENNSYLVANIA,HUNTINGDON,42,061,5879,0.326,4539,0.229,-1340,-0.097
PENNSYLVANIA,INDIANA,42,063,15831,0.437,11528,0.302,-4303,-0.135
PENNSYLVANIA,JEFFERSON,42,065,6073,0.310,3650,0.186,-2423,-0.124
PENNSYLVANIA,JUNIATA,42,067,2797,0.280,1821,0.173,-976,-0.107
PENNSYLVANIA,LACKAWANNA,42,069,59573,0.563,51983,0.498,-7590,-0.065
PENNSYLVANIA,LANCASTER,42,071,74328,0.336,91093,0.372,16765,0.036
PENNSYLVANIA,LAWRENCE,42,073,21387,0.492,14009,0.341,-7378,-0.151
PENNSYLVANIA,LEBANON,42,075,18109,0.325,18953,0.304,844,-0.021
PENNSYLVANIA,LEHIGH,42,077,73940,0.510,81324,0.505,7384,-0.005
PENNSYLVANIA,LUZERNE,42,079,69573,0.511,52451,0.386,-17122,-0.125
PENNSYLVANIA,LYCOMING,42,081,15681,0.313,13020,0.255,-2661,-0.058
PENNSYLVANIA,MCKEAN,42,083,6294,0.361,4025,0.245,-2269,-0.116
PENNSYLVANIA,MERCER,42,085,24831,0.482,18733,0.355,-6098,-0.127
PENNSYLVANIA,MIFFLIN,42,087,4889,0.291,3877,0.207,-1012,-0.084
PENNSYLVANIA,MONROE,42,089,27967,0.496,33918,0.486,5951,-0.010
PENNSYLVANIA,MONTGOMERY,42,091,222048,0.556,256082,0.584,34034,0.028
PENNSYLVANIA,MONTOUR,42,093,2666,0.350,2857,0.334,191,-0.016
PENNSYLVANIA,NORTHAMPTON,42,095,63446,0.501,66272,0.458,2826,-0.043
PENNSYLVANIA,NORTHUMBERLAND,42,097,14602,0.393,9788,0.265,-4814,-0.128
PENNSYLVANIA,PERRY,42,099,5423,0.279,4632,0.217,-791,-0.062
PENNSYLVANIA,PHILADELPHIA,42,101,542205,0.804,584025,0.823,41820,0.019
PENNSYLVANIA,PIKE,42,103,8656,0.406,9256,0.355,600,-0.051
PENNSYLVANIA,POTTER,42,105,2268,0.285,1302,0.167,-966,-0.118
PENNSYLVANIA,SCHUYLKILL,42,107,29231,0.448,16770,0.265,-12461,-0.183
PENNSYLVANIA,SNYDER,42,109,4348,0.290,4002,0.243,-346,-0.047
PENNSYLVANIA,SOMERSET,42,111,12842,0.349,7376,0.204,-5466,-0.145
PENNSYLVANIA,SULLIVAN,42,113,1213,0.369,750,0.239,-463,-0.130
PENNSYLVANIA,SUSQUEHANNA,42,115,7351,0.386,5123,0.269,-2228,-0.117
PENNSYLVANIA,TIOGA,42,117,5437,0.309,3901,0.211,-1536,-0.098
PENNSYLVANIA,UNION,42,119,5700,0.354,6180,0.349,480,-0.005
PENNSYLVANIA,VENANGO,42,121,9024,0.381,6309,0.268,-2715,-0.113
PENNSYLVANIA,WARREN,42,123,8044,0.417,5145,0.279,-2899,-0.138
PENNSYLVANIA,WASHINGTON,42,125,48225,0.501,36322,0.355,-11903,-0.146
PENNSYLVANIA,WAYNE,42,127,8060,0.367,7008,0.292,-1052,-0.075
PENNSYLVANIA,WESTMORELAND,42,129,77774,0.435,59669,0.325,-18105,-0.110
PENNSYLVANIA,WYOMING,42,131,4982,0.388,3811,0.288,-1171,-0.100
PENNSYLVANIA,YORK,42,133,63701,0.355,68524,0.329,4823,-0.026
RHODE-ISLAND,PROVIDENCE,44,007,144811,0.626,142899,0.575,-1912,-0.051
RHODE-ISLAND,BRISTOL,44,001,14448,0.584,14609,0.573,161,-0.011
RHODE-ISLAND,NEWPORT,44,005,22992,0.569,22851,0.557,-141,-0.012
RHODE-ISLAND,WASHINGTON,44,009,34679,0.554,33741,0.508,-938,-0.046
RHODE-ISLAND,KENT,44,003,42830,0.549,37788,0.461,-5042,-0.088
SOUTH-CAROLINA,ABBEVILLE,45,001,4389,0.442,3741,0.347,-648,-0.095
SOUTH-CAROLINA,AIKEN,45,003,19687,0.333,25455,0.340,5768,0.008
SOUTH-CAROLINA,ALLENDALE,45,005,2563,0.714,2735,0.761,172,0.047
SOUTH-CAROLINA,ANDERSON,45,007,20670,0.320,21097,0.262,427,-0.058
SOUTH-CAROLINA,BAMBERG,45,009,3837,0.636,3898,0.627,61,-0.009
SOUTH-CAROLINA,BARNWELL,45,011,3979,0.459,4400,0.464,421,0.005
SOUTH-CAROLINA,BEAUFORT,45,013,17880,0.387,32138,0.409,14258,0.022
SOUTH-CAROLINA,BERKELEY,45,015,18289,0.380,30705,0.386,12416,0.006
SOUTH-CAROLINA,CALHOUN,45,017,3390,0.490,3573,0.473,183,-0.017
SOUTH-CAROLINA,CHARLESTON,45,019,56636,0.470,89299,0.506,32663,0.036
SOUTH-CAROLINA,CHEROKEE,45,021,6443,0.345,6092,0.280,-351,-0.065
SOUTH-CAROLINA,CHESTER,45,023,5200,0.494,6579,0.464,1379,-0.030
SOUTH-CAROLINA,CHESTERFIELD,45,025,6642,0.478,6858,0.414,216,-0.064
SOUTH-CAROLINA,CLARENDON,45,027,7050,0.537,7732,0.502,682,-0.035
SOUTH-CAROLINA,COLLETON,45,029,6672,0.475,7627,0.442,955,-0.033
SOUTH-CAROLINA,DARLINGTON,45,031,11811,0.465,13888,0.468,2077,0.003
SOUTH-CAROLINA,DILLON,45,033,4831,0.524,5834,0.499,1003,-0.025
SOUTH-CAROLINA,DORCHESTER,45,035,14733,0.357,24055,0.384,9322,0.027
SOUTH-CAROLINA,EDGEFIELD,45,037,4051,0.416,4491,0.386,440,-0.030
SOUTH-CAROLINA,FAIRFIELD,45,039,5423,0.621,6945,0.616,1522,-0.005
SOUTH-CAROLINA,FLORENCE,45,041,21267,0.432,26710,0.461,5443,0.029
SOUTH-CAROLINA,GEORGETOWN,45,043,10456,0.450,13310,0.420,2854,-0.030
SOUTH-CAROLINA,GREENVILLE,45,045,54286,0.328,74483,0.346,20197,0.018
SOUTH-CAROLINA,GREENWOOD,45,047,8859,0.382,10711,0.372,1852,-0.010
SOUTH-CAROLINA,HAMPTON,45,049,4096,0.587,5170,0.587,1074,0.000
SOUTH-CAROLINA,HORRY,45,051,29489,0.363,39410,0.296,9921,-0.067
SOUTH-CAROLINA,JASPER,45,053,3828,0.561,5956,0.521,2128,-0.040
SOUTH-CAROLINA,KERSHAW,45,055,8515,0.370,10330,0.356,1815,-0.014
SOUTH-CAROLINA,LANCASTER,45,057,7043,0.367,13812,0.355,6769,-0.012
SOUTH-CAROLINA,LAURENS,45,059,9109,0.385,8889,0.335,-220,-0.050
SOUTH-CAROLINA,LEE,45,061,4577,0.634,5199,0.637,622,0.003
SOUTH-CAROLINA,LEXINGTON,45,063,25334,0.272,35230,0.289,9896,0.017
SOUTH-CAROLINA,MARION,45,067,2071,0.494,8569,0.600,6498,0.106
SOUTH-CAROLINA,MARLBORO,45,069,4984,0.582,5954,0.573,970,-0.009
SOUTH-CAROLINA,MCCORMICK,45,065,2643,0.517,2479,0.475,-164,-0.042
SOUTH-CAROLINA,NEWBERRY,45,071,4273,0.362,6217,0.370,1944,0.008
SOUTH-CAROLINA,OCONEE,45,073,8326,0.304,7998,0.238,-328,-0.066
SOUTH-CAROLINA,ORANGEBURG,45,075,24655,0.657,26318,0.676,1663,0.019
SOUTH-CAROLINA,PICKENS,45,077,10272,0.254,10354,0.211,82,-0.043
SOUTH-CAROLINA,RICHLAND,45,079,65098,0.573,108000,0.640,42902,0.067
SOUTH-CAROLINA,SALUDA,45,081,2183,0.384,2813,0.328,630,-0.056
SOUTH-CAROLINA,SPARTANBURG,45,083,33545,0.347,39997,0.330,6452,-0.017
SOUTH-CAROLINA,SUMTER,45,085,18582,0.506,24047,0.545,5465,0.039
SOUTH-CAROLINA,UNION,45,087,5036,0.429,4729,0.391,-307,-0.038
SOUTH-CAROLINA,WILLIAMSBURG,45,089,9039,0.650,9953,0.661,914,0.011
SOUTH-CAROLINA,YORK,45,091,24201,0.345,41593,0.364,17392,0.019
SOUTH-DAKOTA,AURORA,46,003,620,0.376,340,0.242,-280,-0.134
SOUTH-DAKOTA,BEADLE,46,005,3443,0.406,1912,0.282,-1531,-0.124
SOUTH-DAKOTA,BENNETT,46,007,759,0.466,412,0.359,-347,-0.107
SOUTH-DAKOTA,BONHOMME,46,009,1293,0.379,704,0.237,-589,-0.142
SOUTH-DAKOTA,BROOKINGS,46,011,5443,0.407,4879,0.385,-564,-0.022
SOUTH-DAKOTA,BROWN,46,013,7943,0.427,5452,0.338,-2491,-0.089
SOUTH-DAKOTA,BRULE,46,015,1040,0.396,571,0.250,-469,-0.146
SOUTH-DAKOTA,BUFFALO,46,017,603,0.717,296,0.604,-307,-0.113
SOUTH-DAKOTA,BUTTE,46,019,1009,0.236,696,0.160,-313,-0.076
SOUTH-DAKOTA,CAMPBELL,46,021,239,0.249,105,0.126,-134,-0.123
SOUTH-DAKOTA,CHARLESMIX,46,023,2155,0.449,935,0.272,-1220,-0.177
SOUTH-DAKOTA,CLARK,46,025,875,0.376,398,0.240,-477,-0.136
SOUTH-DAKOTA,CLAY,46,027,3315,0.540,2608,0.514,-707,-0.026
SOUTH-DAKOTA,CODINGTON,46,029,4803,0.377,3174,0.272,-1629,-0.105
SOUTH-DAKOTA,CORSON,46,031,972,0.564,535,0.455,-437,-0.109
SOUTH-DAKOTA,CUSTER,46,033,1272,0.296,1121,0.237,-151,-0.059
SOUTH-DAKOTA,DAVISON,46,035,3263,0.364,2355,0.296,-908,-0.068
SOUTH-DAKOTA,DAY,46,037,1817,0.513,974,0.355,-843,-0.158
SOUTH-DAKOTA,DEUEL,46,039,961,0.398,570,0.274,-391,-0.124
SOUTH-DAKOTA,DEWEY,46,041,1606,0.626,888,0.520,-718,-0.106
SOUTH-DAKOTA,DOUGLAS,46,043,393,0.195,214,0.133,-179,-0.062
SOUTH-DAKOTA,EDMUNDS,46,045,765,0.342,380,0.198,-385,-0.144
SOUTH-DAKOTA,FALLRIVER,46,047,1326,0.345,821,0.230,-505,-0.115
SOUTH-DAKOTA,FAULK,46,049,418,0.305,204,0.182,-214,-0.123
SOUTH-DAKOTA,GRANT,46,051,1633,0.399,971,0.272,-662,-0.127
SOUTH-DAKOTA,GREGORY,46,053,813,0.319,391,0.187,-422,-0.132
SOUTH-DAKOTA,HAAKON,46,055,219,0.177,77,0.074,-142,-0.103
SOUTH-DAKOTA,HAMLIN,46,057,1015,0.337,555,0.201,-460,-0.136
SOUTH-DAKOTA,HAND,46,059,668,0.305,334,0.184,-334,-0.121
SOUTH-DAKOTA,HANSON,46,061,745,0.347,424,0.211,-321,-0.136
SOUTH-DAKOTA,HARDING,46,063,94,0.115,38,0.049,-56,-0.066
SOUTH-DAKOTA,HUGHES,46,065,2697,0.305,2450,0.300,-247,-0.005
SOUTH-DAKOTA,HUTCHINSON,46,067,1177,0.284,692,0.206,-485,-0.078
SOUTH-DAKOTA,HYDE,46,069,259,0.288,125,0.181,-134,-0.107
SOUTH-DAKOTA,JACKSON,46,071,508,0.400,323,0.295,-185,-0.105
SOUTH-DAKOTA,JERAULD,46,073,482,0.390,264,0.273,-218,-0.117
SOUTH-DAKOTA,JONES,46,075,134,0.187,69,0.124,-65,-0.063
SOUTH-DAKOTA,KINGSBURY,46,077,1163,0.386,703,0.276,-460,-0.110
SOUTH-DAKOTA,LAKE,46,079,2509,0.418,2314,0.341,-195,-0.077
SOUTH-DAKOTA,LAWRENCE,46,081,3857,0.332,3356,0.283,-501,-0.049
SOUTH-DAKOTA,LINCOLN,46,083,5703,0.334,8076,0.320,2373,-0.014
SOUTH-DAKOTA,LYMAN,46,085,872,0.449,369,0.260,-503,-0.189
SOUTH-DAKOTA,MCCOOK,46,087,1201,0.367,623,0.241,-578,-0.126
SOUTH-DAKOTA,MCPHERSON,46,089,369,0.234,192,0.169,-177,-0.065
SOUTH-DAKOTA,MARSHALL,46,091,1099,0.465,754,0.387,-345,-0.078
SOUTH-DAKOTA,MEADE,46,093,2941,0.256,2223,0.191,-718,-0.065
SOUTH-DAKOTA,MELLETTE,46,095,361,0.388,238,0.348,-123,-0.040
SOUTH-DAKOTA,MINER,46,097,641,0.436,281,0.264,-360,-0.172
SOUTH-DAKOTA,MINNEHAHA,46,099,32314,0.416,30610,0.391,-1704,-0.025
SOUTH-DAKOTA,MOODY,46,101,1609,0.466,1043,0.356,-566,-0.110
SOUTH-DAKOTA,PENNINGTON,46,103,14213,0.316,14074,0.295,-139,-0.021
SOUTH-DAKOTA,PERKINS,46,105,418,0.231,188,0.117,-230,-0.114
SOUTH-DAKOTA,POTTER,46,107,463,0.286,215,0.161,-248,-0.125
SOUTH-DAKOTA,ROBERTS,46,109,2527,0.507,1540,0.396,-987,-0.111
SOUTH-DAKOTA,SANBORN,46,111,581,0.407,241,0.215,-340,-0.192
SOUTH-DAKOTA,SHANNON,46,113,3566,0.846,2510,0.864,-1056,0.018
SOUTH-DAKOTA,SPINK,46,115,1478,0.392,919,0.311,-559,-0.081
SOUTH-DAKOTA,STANLEY,46,117,464,0.286,329,0.210,-135,-0.076
SOUTH-DAKOTA,SULLY,46,119,201,0.219,137,0.159,-64,-0.060
SOUTH-DAKOTA,TODD,46,121,2543,0.722,1505,0.708,-1038,-0.014
SOUTH-DAKOTA,TRIPP,46,123,972,0.300,462,0.176,-510,-0.124
SOUTH-DAKOTA,TURNER,46,125,1646,0.341,961,0.232,-685,-0.109
SOUTH-DAKOTA,UNION,46,127,3000,0.426,2227,0.282,-773,-0.144
SOUTH-DAKOTA,WALWORTH,46,129,878,0.305,457,0.184,-421,-0.121
SOUTH-DAKOTA,YANKTON,46,135,4237,0.406,3301,0.343,-936,-0.063
SOUTH-DAKOTA,ZIEBACH,46,137,641,0.574,353,0.460,-288,-0.114
TENNESSEE,ANDERSON,47,001,12896,0.407,9013,0.302,-3883,-0.105
TENNESSEE,BEDFORD,47,003,5268,0.384,3395,0.221,-1873,-0.163
TENNESSEE,BENTON,47,005,3869,0.546,1474,0.233,-2395,-0.313
TENNESSEE,BLEDSOE,47,007,1927,0.401,897,0.192,-1030,-0.209
TENNESSEE,BLOUNT,47,009,15047,0.309,12100,0.232,-2947,-0.077
TENNESSEE,BRADLEY,47,011,9431,0.265,7070,0.183,-2361,-0.082
TENNESSEE,CAMPBELL,47,013,6163,0.437,2248,0.179,-3915,-0.258
TENNESSEE,CANNON,47,015,2515,0.459,1127,0.212,-1388,-0.247
TENNESSEE,CARROLL,47,017,5070,0.431,2327,0.224,-2743,-0.207
TENNESSEE,CARTER,47,019,6395,0.287,3453,0.164,-2942,-0.123
TENNESSEE,CHEATHAM,47,021,5918,0.377,3878,0.244,-2040,-0.133
TENNESSEE,CHESTER,47,023,2242,0.353,1243,0.191,-999,-0.162
TENNESSEE,CLAIBORNE,47,025,4034,0.383,1832,0.171,-2202,-0.212
TENNESSEE,CLAY,47,027,1675,0.499,707,0.242,-968,-0.257
TENNESSEE,COCKE,47,029,3935,0.320,1981,0.163,-1954,-0.157
TENNESSEE,COFFEE,47,031,8243,0.409,4743,0.237,-3500,-0.172
TENNESSEE,CROCKETT,47,033,2459,0.430,1303,0.241,-1156,-0.189
TENNESSEE,CUMBERLAND,47,035,8327,0.352,5202,0.197,-3125,-0.155
TENNESSEE,DAVIDSON,47,037,132737,0.548,148864,0.598,16127,0.050
TENNESSEE,DECATUR,47,039,2268,0.465,894,0.195,-1374,-0.270
TENNESSEE,DEKALB,47,041,3445,0.480,1569,0.226,-1876,-0.254
TENNESSEE,DICKSON,47,043,8597,0.445,4722,0.253,-3875,-0.192
TENNESSEE,DYER,47,045,5287,0.383,2816,0.211,-2471,-0.172
TENNESSEE,FAYETTE,47,047,5696,0.387,5874,0.303,178,-0.084
TENNESSEE,FENTRESS,47,049,2371,0.354,1100,0.150,-1271,-0.204
TENNESSEE,FRANKLIN,47,051,7800,0.457,4374,0.267,-3426,-0.190
TENNESSEE,GIBSON,47,053,8511,0.443,5258,0.269,-3253,-0.174
TENNESSEE,GILES,47,055,5273,0.457,2917,0.262,-2356,-0.195
TENNESSEE,GRAINGER,47,057,2569,0.341,1154,0.144,-1415,-0.197
TENNESSEE,GREENE,47,059,7635,0.316,4216,0.179,-3419,-0.137
TENNESSEE,GRUNDY,47,061,2789,0.566,999,0.210,-1790,-0.356
TENNESSEE,HAMBLEN,47,063,7433,0.333,4075,0.197,-3358,-0.136
TENNESSEE,HAMILTON,47,065,57302,0.418,55316,0.388,-1986,-0.030
TENNESSEE,HANCOCK,47,067,777,0.305,322,0.144,-455,-0.161
TENNESSEE,HARDEMAN,47,069,5685,0.543,4185,0.451,-1500,-0.092
TENNESSEE,HARDIN,47,071,3834,0.385,1622,0.163,-2212,-0.222
TENNESSEE,HAWKINS,47,073,6684,0.330,3507,0.169,-3177,-0.161
TENNESSEE,HAYWOOD,47,075,4359,0.578,3711,0.543,-648,-0.035
TENNESSEE,HENDERSON,47,077,3448,0.342,1800,0.176,-1648,-0.166
TENNESSEE,HENRY,47,079,5732,0.435,3063,0.237,-2669,-0.198
TENNESSEE,HICKMAN,47,081,4263,0.492,1824,0.233,-2439,-0.259
TENNESSEE,HOUSTON,47,083,2126,0.591,866,0.273,-1260,-0.318
TENNESSEE,HUMPHREYS,47,085,4485,0.576,1967,0.275,-2518,-0.301
TENNESSEE,JACKSON,47,087,2998,0.593,1129,0.253,-1869,-0.340
TENNESSEE,JEFFERSON,47,089,5469,0.318,3494,0.183,-1975,-0.135
TENNESSEE,JOHNSON,47,091,1812,0.280,988,0.150,-824,-0.130
TENNESSEE,KNOX,47,093,66013,0.370,62878,0.348,-3135,-0.022
TENNESSEE,LAKE,47,095,2634,0.556,577,0.293,-2057,-0.263
TENNESSEE,LAUDERDALE,47,097,4474,0.515,3056,0.378,-1418,-0.137
TENNESSEE,LAWRENCE,47,099,6592,0.396,2821,0.180,-3771,-0.216
TENNESSEE,LEWIS,47,101,2192,0.434,890,0.193,-1302,-0.241
TENNESSEE,LINCOLN,47,103,4546,0.365,2554,0.191,-1992,-0.174
TENNESSEE,LOUDON,47,105,5708,0.287,4919,0.210,-789,-0.077
TENNESSEE,MCMINN,47,107,5891,0.327,3510,0.187,-2381,-0.140
TENNESSEE,MCNAIRY,47,109,4101,0.413,1848,0.184,-2253,-0.229
TENNESSEE,MACON,47,111,2738,0.368,1072,0.143,-1666,-0.225
TENNESSEE,MADISON,47,113,16840,0.435,15448,0.405,-1392,-0.030
TENNESSEE,MARION,47,115,5548,0.483,2832,0.261,-2716,-0.222
TENNESSEE,MARSHALL,47,117,4722,0.445,2852,0.249,-1870,-0.196
TENNESSEE,MAURY,47,119,12379,0.412,10038,0.284,-2341,-0.128
TENNESSEE,MEIGS,47,121,1595,0.386,856,0.198,-739,-0.188
TENNESSEE,MONROE,47,123,5354,0.344,3186,0.186,-2168,-0.158
TENNESSEE,MONTGOMERY,47,125,20070,0.410,21699,0.377,1629,-0.033
TENNESSEE,MOORE,47,127,1084,0.391,496,0.170,-588,-0.221
TENNESSEE,MORGAN,47,129,2924,0.397,1054,0.157,-1870,-0.240
TENNESSEE,OBION,47,131,5549,0.410,2426,0.198,-3123,-0.212
TENNESSEE,OVERTON,47,133,4518,0.531,1945,0.236,-2573,-0.295
TENNESSEE,PERRY,47,135,1579,0.501,597,0.209,-982,-0.292
TENNESSEE,PICKETT,47,137,1033,0.391,536,0.205,-497,-0.186
TENNESSEE,POLK,47,139,2724,0.407,1252,0.192,-1472,-0.215
TENNESSEE,PUTNAM,47,141,10566,0.400,6851,0.252,-3715,-0.148
TENNESSEE,RHEA,47,143,3665,0.332,1942,0.176,-1723,-0.156
TENNESSEE,ROANE,47,145,8706,0.373,4837,0.223,-3869,-0.150
TENNESSEE,ROBERTSON,47,147,9865,0.390,6637,0.245,-3228,-0.145
TENNESSEE,RUTHERFORD,47,149,31647,0.375,36706,0.342,5059,-0.033
TENNESSEE,SCOTT,47,151,3086,0.405,934,0.131,-2152,-0.274
TENNESSEE,SEQUATCHIE,47,153,1986,0.399,1053,0.185,-933,-0.214
TENNESSEE,SEVIER,47,155,8621,0.278,6297,0.173,-2324,-0.105
TENNESSEE,SHELBY,47,157,216945,0.575,208992,0.619,-7953,0.044
TENNESSEE,SMITH,47,159,4044,0.517,1689,0.227,-2355,-0.290
TENNESSEE,STEWART,47,161,2860,0.512,1222,0.231,-1638,-0.281
TENNESSEE,SULLIVAN,47,163,19637,0.313,12578,0.202,-7059,-0.111
TENNESSEE,SUMNER,47,165,21458,0.346,18161,0.254,-3297,-0.092
TENNESSEE,TIPTON,47,167,7379,0.340,5785,0.246,-1594,-0.094
TENNESSEE,TROUSDALE,47,169,1851,0.580,946,0.299,-905,-0.281
TENNESSEE,UNICOI,47,171,2374,0.318,1262,0.175,-1112,-0.143
TENNESSEE,UNION,47,173,2524,0.376,1012,0.162,-1512,-0.214
TENNESSEE,VANBUREN,47,175,1209,0.515,539,0.223,-670,-0.292
TENNESSEE,WARREN,47,177,6808,0.473,3535,0.260,-3273,-0.213
TENNESSEE,WASHINGTON,47,179,14944,0.332,13024,0.262,-1920,-0.070
TENNESSEE,WAYNE,47,181,1951,0.326,717,0.122,-1234,-0.204
TENNESSEE,WEAKLEY,47,183,5588,0.414,2772,0.228,-2816,-0.186
TENNESSEE,WHITE,47,185,4147,0.437,1845,0.188,-2302,-0.249
TENNESSEE,WILLIAMSON,47,187,21732,0.273,31013,0.292,9281,0.019
TENNESSEE,WILSON,47,189,15277,0.344,14385,0.254,-892,-0.090
TEXAS,ANDERSON,48,001,4678,0.287,3369,0.198,-1309,-0.089
TEXAS,ANDREWS,48,003,677,0.149,836,0.169,159,0.020
TEXAS,ANGELINA,48,005,9302,0.328,7538,0.252,-1764,-0.076
TEXAS,ARANSAS,48,007,2640,0.285,2465,0.234,-175,-0.051
TEXAS,ARCHER,48,009,878,0.197,394,0.092,-484,-0.105
TEXAS,ARMSTRONG,48,011,170,0.169,70,0.069,-100,-0.100
TEXAS,ATASCOSA,48,013,4421,0.365,4651,0.340,230,-0.025
TEXAS,AUSTIN,48,015,2582,0.241,2320,0.189,-262,-0.052
TEXAS,BAILEY,48,017,525,0.218,397,0.221,-128,0.003
TEXAS,BANDERA,48,019,1738,0.199,1726,0.169,-12,-0.030
TEXAS,BASTROP,48,021,9794,0.418,10569,0.371,775,-0.047
TEXAS,BAYLOR,48,023,467,0.285,191,0.127,-276,-0.158
TEXAS,BEE,48,025,4045,0.425,3444,0.406,-601,-0.019
TEXAS,BELL,48,027,27165,0.341,37801,0.398,10636,0.057
TEXAS,BEXAR,48,029,210976,0.444,319550,0.542,108574,0.098
TEXAS,BLANCO,48,031,1267,0.276,1244,0.219,-23,-0.057
TEXAS,BORDEN,48,033,55,0.153,31,0.085,-24,-0.068
TEXAS,BOSQUE,48,035,1815,0.239,1278,0.163,-537,-0.076
TEXAS,BOWIE,48,037,11880,0.352,8838,0.255,-3042,-0.097
TEXAS,BRAZORIA,48,039,28904,0.310,43200,0.356,14296,0.046
TEXAS,BRAZOS,48,041,16128,0.297,23121,0.344,6993,0.047
TEXAS,BREWSTER,48,043,1729,0.460,1873,0.440,144,-0.020
TEXAS,BRISCOE,48,045,191,0.236,91,0.124,-100,-0.112
TEXAS,BROOKS,48,047,1823,0.682,1937,0.746,114,0.064
TEXAS,BROWN,48,049,2523,0.177,1621,0.116,-902,-0.061
TEXAS,BURLESON,48,051,2276,0.339,1491,0.214,-785,-0.125
TEXAS,BURNET,48,053,4147,0.263,3797,0.198,-350,-0.065
TEXAS,CALDWELL,48,055,5052,0.436,4795,0.397,-257,-0.039
TEXAS,CALHOUN,48,057,2561,0.370,2118,0.304,-443,-0.066
TEXAS,CALLAHAN,48,059,1073,0.190,569,0.102,-504,-0.088
TEXAS,CAMERON,48,061,33998,0.492,59402,0.645,25404,0.153
TEXAS,CAMP,48,063,1778,0.401,1260,0.277,-518,-0.124
TEXAS,CARSON,48,065,485,0.165,249,0.084,-236,-0.081
TEXAS,CASS,48,067,4630,0.384,2391,0.194,-2239,-0.190
TEXAS,CASTRO,48,069,631,0.260,526,0.263,-105,0.003
TEXAS,CHAMBERS,48,071,2953,0.253,2948,0.176,-5,-0.077
TEXAS,CHEROKEE,48,073,4439,0.280,3469,0.207,-970,-0.073
TEXAS,CHILDRESS,48,075,511,0.238,253,0.121,-258,-0.117
TEXAS,CLAY,48,077,1299,0.246,536,0.107,-763,-0.139
TEXAS,COCHRAN,48,079,249,0.224,190,0.211,-59,-0.013
TEXAS,COKE,48,081,266,0.165,140,0.098,-126,-0.067
TEXAS,COLEMAN,48,083,778,0.203,388,0.107,-390,-0.096
TEXAS,COLLIN,48,085,68935,0.281,140624,0.389,71689,0.108
TEXAS,COLLINGSWORTH,48,087,346,0.247,145,0.125,-201,-0.122
TEXAS,COLORADO,48,089,2161,0.281,1987,0.233,-174,-0.048
TEXAS,COMAL,48,091,9153,0.223,14238,0.229,5085,0.006
TEXAS,COMANCHE,48,093,1431,0.272,789,0.151,-642,-0.121
TEXAS,CONCHO,48,095,270,0.226,148,0.139,-122,-0.087
TEXAS,COOKE,48,097,3142,0.208,2352,0.147,-790,-0.061
TEXAS,CORYELL,48,099,5122,0.291,5064,0.277,-58,-0.014
TEXAS,COTTLE,48,101,214,0.279,92,0.150,-122,-0.129
TEXAS,CRANE,48,103,254,0.161,299,0.216,45,0.055
TEXAS,CROCKETT,48,105,473,0.274,372,0.267,-101,-0.007
TEXAS,CROSBY,48,107,622,0.273,468,0.271,-154,-0.002
TEXAS,CULBERSON,48,109,375,0.476,454,0.592,79,0.116
TEXAS,DALLAM,48,111,305,0.171,222,0.144,-83,-0.027
TEXAS,DALLAS,48,113,336641,0.490,461080,0.608,124439,0.118
TEXAS,DAWSON,48,115,1114,0.245,835,0.234,-279,-0.011
TEXAS,DEAFSMITH,48,117,1133,0.214,1185,0.281,52,0.067
TEXAS,DELTA,48,119,627,0.301,400,0.175,-227,-0.126
TEXAS,DENTON,48,121,59346,0.295,110890,0.371,51544,0.076
TEXAS,DEWITT,48,123,1610,0.239,1163,0.170,-447,-0.069
TEXAS,DICKENS,48,125,245,0.230,128,0.141,-117,-0.089
TEXAS,DIMMIT,48,127,2365,0.663,2173,0.674,-192,0.011
TEXAS,DONLEY,48,129,349,0.196,191,0.130,-158,-0.066
TEXAS,DUVAL,48,131,2916,0.713,2783,0.668,-133,-0.045
TEXAS,EASTLAND,48,133,1582,0.231,776,0.111,-806,-0.120
TEXAS,ECTOR,48,135,8579,0.236,10249,0.281,1670,0.045
TEXAS,EDWARDS,48,137,217,0.225,303,0.282,86,0.057
TEXAS,ELLIS,48,139,11640,0.251,16253,0.255,4613,0.004
TEXAS,ELPASO,48,141,95142,0.561,147843,0.691,52701,0.130
TEXAS,ERATH,48,143,2710,0.221,2160,0.155,-550,-0.066
TEXAS,FALLS,48,145,2427,0.411,1684,0.321,-743,-0.090
TEXAS,FANNIN,48,147,4001,0.335,2132,0.177,-1869,-0.158
TEXAS,FAYETTE,48,149,2803,0.270,2144,0.192,-659,-0.078
TEXAS,FISHER,48,151,758,0.394,403,0.233,-355,-0.161
TEXAS,FLOYD,48,153,545,0.211,435,0.222,-110,0.011
TEXAS,FOARD,48,155,235,0.400,113,0.220,-122,-0.180
TEXAS,FORTBEND,48,157,68722,0.421,134686,0.514,65964,0.093
TEXAS,FRANKLIN,48,159,1011,0.240,665,0.152,-346,-0.088
TEXAS,FREESTONE,48,161,2070,0.289,1471,0.191,-599,-0.098
TEXAS,FRIO,48,163,1931,0.491,2444,0.555,513,0.064
TEXAS,GAINES,48,165,608,0.146,597,0.129,-11,-0.017
TEXAS,GALVESTON,48,167,43919,0.414,43658,0.355,-261,-0.059
TEXAS,GARZA,48,169,326,0.180,230,0.155,-96,-0.025
TEXAS,GILLESPIE,48,171,2104,0.182,2288,0.173,184,-0.009
TEXAS,GLASSCOCK,48,173,44,0.083,34,0.056,-10,-0.027
TEXAS,GOLIAD,48,175,1219,0.348,973,0.262,-246,-0.086
TEXAS,GONZALES,48,177,1709,0.284,1571,0.248,-138,-0.036
TEXAS,GRAY,48,179,1289,0.150,701,0.095,-588,-0.055
TEXAS,GRAYSON,48,181,13452,0.303,10301,0.217,-3151,-0.086
TEXAS,GREGG,48,183,12306,0.290,11677,0.280,-629,-0.010
TEXAS,GRIMES,48,185,2713,0.338,2194,0.230,-519,-0.108
TEXAS,GUADALUPE,48,187,10290,0.266,18391,0.318,8101,0.052
TEXAS,HALE,48,189,2078,0.205,2101,0.237,23,0.032
TEXAS,HALL,48,191,413,0.323,164,0.150,-249,-0.173
TEXAS,HAMILTON,48,193,845,0.227,479,0.132,-366,-0.095
TEXAS,HANSFORD,48,195,240,0.112,171,0.088,-69,-0.024
TEXAS,HARDEMAN,48,197,480,0.282,249,0.165,-231,-0.117
TEXAS,HARDIN,48,199,5608,0.271,2780,0.122,-2828,-0.149
TEXAS,HARRIS,48,201,475865,0.446,707914,0.540,232049,0.094
TEXAS,HARRISON,48,203,9642,0.368,7151,0.269,-2491,-0.099
TEXAS,HARTLEY,48,205,315,0.153,173,0.089,-142,-0.064
TEXAS,HASKELL,48,207,867,0.359,314,0.177,-553,-0.182
TEXAS,HAYS,48,209,20110,0.421,33224,0.460,13114,0.039
TEXAS,HEMPHILL,48,211,257,0.156,181,0.107,-76,-0.049
TEXAS,HENDERSON,48,213,8505,0.295,5669,0.189,-2836,-0.106
TEXAS,HIDALGO,48,215,62369,0.549,118809,0.685,56440,0.136
TEXAS,HILL,48,217,3751,0.287,2547,0.196,-1204,-0.091
TEXAS,HOCKLEY,48,219,1385,0.183,1260,0.172,-125,-0.011
TEXAS,HOOD,48,221,4865,0.228,4008,0.153,-857,-0.075
TEXAS,HOPKINS,48,223,3443,0.285,2510,0.185,-933,-0.100
TEXAS,HOUSTON,48,225,2921,0.332,1978,0.237,-943,-0.095
TEXAS,HOWARD,48,227,2663,0.261,1770,0.203,-893,-0.058
TEXAS,HUDSPETH,48,229,302,0.341,324,0.372,22,0.031
TEXAS,HUNT,48,231,7971,0.283,6396,0.203,-1575,-0.080
TEXAS,HUTCHINSON,48,233,1503,0.160,854,0.105,-649,-0.055
TEXAS,IRION,48,235,141,0.170,90,0.117,-51,-0.053
TEXAS,JACK,48,237,643,0.206,314,0.094,-329,-0.112
TEXAS,JACKSON,48,239,1296,0.255,904,0.171,-392,-0.084
TEXAS,JASPER,48,241,4471,0.347,2590,0.193,-1881,-0.154
TEXAS,JEFFDAVIS,48,243,378,0.324,422,0.354,44,0.030
TEXAS,JEFFERSON,48,245,47066,0.512,42443,0.484,-4623,-0.028
TEXAS,JIMHOGG,48,247,1344,0.651,1635,0.772,291,0.121
TEXAS,JIMWELLS,48,249,6824,0.538,6694,0.541,-130,0.003
TEXAS,JOHNSON,48,251,12325,0.260,10988,0.191,-1337,-0.069
TEXAS,JONES,48,253,1658,0.280,936,0.157,-722,-0.123
TEXAS,KARNES,48,255,1543,0.330,1145,0.273,-398,-0.057
TEXAS,KAUFMAN,48,257,8947,0.295,10278,0.249,1331,-0.046
TEXAS,KENDALL,48,259,2532,0.180,3643,0.181,1111,0.001
TEXAS,KENEDY,48,261,85,0.503,99,0.532,14,0.029
TEXAS,KENT,48,263,138,0.264,59,0.136,-79,-0.128
TEXAS,KERR,48,265,4557,0.214,4681,0.201,124,-0.013
TEXAS,KIMBLE,48,267,324,0.178,206,0.106,-118,-0.072
TEXAS,KING,48,269,18,0.115,5,0.031,-13,-0.084
TEXAS,KINNEY,48,271,542,0.339,458,0.320,-84,-0.019
TEXAS,KLEBERG,48,273,4550,0.456,4716,0.496,166,0.040
TEXAS,KNOX,48,275,464,0.299,247,0.181,-217,-0.118
TEXAS,LAMAR,48,277,5338,0.306,3583,0.193,-1755,-0.113
TEXAS,LAMB,48,279,857,0.201,771,0.193,-86,-0.008
TEXAS,LAMPASAS,48,281,1593,0.227,1483,0.181,-110,-0.046
TEXAS,LASALLE,48,283,1229,0.551,1129,0.548,-100,-0.003
TEXAS,LAVACA,48,285,2152,0.263,1170,0.135,-982,-0.128
TEXAS,LEE,48,287,1899,0.312,1372,0.210,-527,-0.102
TEXAS,LEON,48,289,1754,0.258,909,0.122,-845,-0.136
TEXAS,LIBERTY,48,291,6780,0.313,4862,0.200,-1918,-0.113
TEXAS,LIMESTONE,48,293,2752,0.352,1778,0.230,-974,-0.122
TEXAS,LIPSCOMB,48,295,184,0.138,135,0.101,-49,-0.037
TEXAS,LIVEOAK,48,297,1036,0.247,742,0.172,-294,-0.075
TEXAS,LLANO,48,299,2257,0.236,1825,0.175,-432,-0.061
TEXAS,LOVING,48,301,12,0.150,4,0.062,-8,-0.088
TEXAS,LUBBOCK,48,303,22472,0.241,28023,0.283,5551,0.042
TEXAS,LYNN,48,305,490,0.216,403,0.201,-87,-0.015
TEXAS,MCCULLOCH,48,307,745,0.231,482,0.155,-263,-0.076
TEXAS,MCLENNAN,48,309,26760,0.338,27063,0.342,303,0.004
TEXAS,MCMULLEN,48,311,95,0.168,40,0.080,-55,-0.088
TEXAS,MADISON,48,313,1235,0.301,881,0.205,-354,-0.096
TEXAS,MARION,48,315,1884,0.433,1165,0.275,-719,-0.158
TEXAS,MARTIN,48,317,288,0.159,266,0.151,-22,-0.008
TEXAS,MASON,48,319,459,0.221,354,0.172,-105,-0.049
TEXAS,MATAGORDA,48,321,4355,0.348,3500,0.287,-855,-0.061
TEXAS,MAVERICK,48,323,5948,0.593,10397,0.765,4449,0.172
TEXAS,MEDINA,48,325,4322,0.292,4634,0.269,312,-0.023
TEXAS,MENARD,48,327,331,0.300,154,0.178,-177,-0.122
TEXAS,MIDLAND,48,329,8005,0.179,10025,0.204,2020,0.025
TEXAS,MILAM,48,331,3445,0.392,2051,0.237,-1394,-0.155
TEXAS,MILLS,48,333,416,0.186,243,0.108,-173,-0.078
TEXAS,MITCHELL,48,335,639,0.250,354,0.161,-285,-0.089
TEXAS,MONTAGUE,48,337,1946,0.246,885,0.103,-1061,-0.143
TEXAS,MONTGOMERY,48,339,28628,0.214,45835,0.224,17207,0.010
TEXAS,MOORE,48,341,1009,0.179,1098,0.208,89,0.029
TEXAS,MORRIS,48,343,2437,0.462,1425,0.287,-1012,-0.175
TEXAS,MOTLEY,48,345,113,0.165,40,0.065,-73,-0.100
TEXAS,NACOGDOCHES,48,347,7152,0.333,6846,0.303,-306,-0.030
TEXAS,NAVARRO,48,349,5259,0.328,4002,0.244,-1257,-0.084
TEXAS,NEWTON,48,351,2513,0.441,1156,0.209,-1357,-0.232
TEXAS,NOLAN,48,353,1541,0.291,1029,0.212,-512,-0.079
TEXAS,NUECES,48,355,44439,0.425,49198,0.471,4759,0.046
TEXAS,OCHILTREE,48,357,251,0.079,274,0.091,23,0.012
TEXAS,OLDHAM,48,359,108,0.128,78,0.082,-30,-0.046
TEXAS,ORANGE,48,361,11476,0.360,5735,0.179,-5741,-0.181
TEXAS,PALOPINTO,48,363,2816,0.281,1708,0.166,-1108,-0.115
TEXAS,PANOLA,48,365,2958,0.296,1835,0.176,-1123,-0.120
TEXAS,PARKER,48,367,8966,0.219,8344,0.147,-622,-0.072
TEXAS,PARMER,48,369,389,0.140,485,0.197,96,0.057
TEXAS,PECOS,48,371,1242,0.280,1554,0.371,312,0.091
TEXAS,POLK,48,373,6964,0.334,4187,0.211,-2777,-0.123
TEXAS,POTTER,48,375,7489,0.258,7657,0.267,168,0.009
TEXAS,PRESIDIO,48,377,1159,0.613,1458,0.660,299,0.047
TEXAS,RAINS,48,379,1213,0.287,628,0.134,-585,-0.153
TEXAS,RANDALL,48,381,7849,0.162,8367,0.154,518,-0.008
TEXAS,REAGAN,48,383,184,0.161,167,0.185,-17,0.024
TEXAS,REAL,48,385,325,0.198,262,0.156,-63,-0.042
TEXAS,REDRIVER,48,387,2097,0.382,1149,0.223,-948,-0.159
TEXAS,REEVES,48,389,1600,0.471,1659,0.521,59,0.050
TEXAS,REFUGIO,48,391,1232,0.357,1034,0.351,-198,-0.006
TEXAS,ROBERTS,48,393,46,0.091,20,0.036,-26,-0.055
TEXAS,ROBERTSON,48,395,2979,0.438,2203,0.313,-776,-0.125
TEXAS,ROCKWALL,48,397,5320,0.208,9655,0.242,4335,0.034
TEXAS,RUNNELS,48,399,792,0.196,453,0.120,-339,-0.076
TEXAS,RUSK,48,401,4899,0.267,3935,0.207,-964,-0.060
TEXAS,SABINE,48,403,1476,0.318,614,0.132,-862,-0.186
TEXAS,SANAUGUSTINE,48,405,1506,0.401,910,0.255,-596,-0.146
TEXAS,SANJACINTO,48,407,2688,0.331,2038,0.197,-650,-0.134
TEXAS,SANPATRICIO,48,409,7764,0.364,7871,0.363,107,-0.001
TEXAS,SANSABA,48,411,529,0.218,293,0.124,-236,-0.094
TEXAS,SCHLEICHER,48,413,312,0.235,208,0.196,-104,-0.039
TEXAS,SCURRY,48,415,981,0.176,733,0.139,-248,-0.037
TEXAS,SHACKELFORD,48,417,229,0.150,103,0.068,-126,-0.082
TEXAS,SHELBY,48,419,2951,0.318,1758,0.193,-1193,-0.125
TEXAS,SHERMAN,48,421,124,0.116,96,0.103,-28,-0.013
TEXAS,SMITH,48,423,19970,0.271,22300,0.263,2330,-0.008
TEXAS,SOMERVELL,48,425,831,0.234,541,0.139,-290,-0.095
TEXAS,STARR,48,427,7199,0.736,9289,0.791,2090,0.055
TEXAS,STEPHENS,48,429,703,0.200,348,0.101,-355,-0.099
TEXAS,STERLING,48,431,71,0.115,70,0.111,-1,-0.004
TEXAS,STONEWALL,48,433,250,0.332,135,0.193,-115,-0.139
TEXAS,SUTTON,48,435,280,0.193,313,0.221,33,0.028
TEXAS,SWISHER,48,437,626,0.295,462,0.210,-164,-0.085
TEXAS,TARRANT,48,439,207286,0.370,288392,0.431,81106,0.061
TEXAS,TAYLOR,48,441,10648,0.221,10085,0.220,-563,-0.001
TEXAS,TERRELL,48,443,159,0.339,140,0.320,-19,-0.019
TEXAS,TERRY,48,445,794,0.200,753,0.224,-41,0.024
TEXAS,THROCKMORTON,48,447,202,0.234,84,0.104,-118,-0.130
TEXAS,TITUS,48,449,3173,0.356,2597,0.276,-576,-0.080
TEXAS,TOMGREEN,48,451,9007,0.241,9173,0.238,166,-0.003
TEXAS,TRAVIS,48,453,197235,0.560,308260,0.658,111025,0.098
TEXAS,TRINITY,48,455,2204,0.355,1154,0.193,-1050,-0.162
TEXAS,TYLER,48,457,2659,0.343,1248,0.156,-1411,-0.187
TEXAS,UPSHUR,48,459,4225,0.291,2380,0.149,-1845,-0.142
TEXAS,UPTON,48,461,185,0.155,286,0.212,101,0.057
TEXAS,UVALDE,48,463,3298,0.389,3867,0.431,569,0.042
TEXAS,VALVERDE,48,465,4757,0.403,6964,0.511,2207,0.108
TEXAS,VANZANDT,48,467,4822,0.243,2799,0.128,-2023,-0.115
TEXAS,VICTORIA,48,469,8553,0.289,8866,0.285,313,-0.004
TEXAS,WALKER,48,471,5977,0.335,6091,0.308,114,-0.027
TEXAS,WALLER,48,473,6145,0.443,5748,0.342,-397,-0.101
TEXAS,WARD,48,475,901,0.239,783,0.227,-118,-0.012
TEXAS,WASHINGTON,48,477,3389,0.259,3382,0.228,-7,-0.031
TEXAS,WEBB,48,479,23654,0.569,42307,0.743,18653,0.174
TEXAS,WHARTON,48,481,4702,0.335,4238,0.288,-464,-0.047
TEXAS,WHEELER,48,483,420,0.175,194,0.084,-226,-0.091
TEXAS,WICHITA,48,485,12819,0.281,8770,0.230,-4049,-0.051
TEXAS,WILBARGER,48,487,1284,0.257,809,0.197,-475,-0.060
TEXAS,WILLACY,48,489,2734,0.551,3422,0.672,688,0.121
TEXAS,WILLIAMSON,48,491,43117,0.336,84468,0.416,41351,0.080
TEXAS,WILSON,48,493,4409,0.296,4790,0.247,381,-0.049
TEXAS,WINKLER,48,495,391,0.195,420,0.224,29,0.029
TEXAS,WISE,48,497,4783,0.239,3412,0.138,-1371,-0.101
TEXAS,WOOD,48,499,4034,0.238,2630,0.140,-1404,-0.098
TEXAS,YOAKUM,48,501,376,0.144,426,0.185,50,0.041
TEXAS,YOUNG,48,503,1511,0.204,876,0.114,-635,-0.090
TEXAS,ZAPATA,48,505,1662,0.573,2063,0.657,401,0.084
TEXAS,ZAVALA,48,507,2332,0.748,2636,0.776,304,0.028
UTAH,BEAVER,49,001,493,0.194,264,0.105,-229,-0.089
UTAH,BOXELDER,49,003,2244,0.122,2282,0.115,38,-0.007
UTAH,CACHE,49,005,6375,0.161,8563,0.183,2188,0.022
UTAH,CARBON,49,007,3415,0.401,1717,0.215,-1698,-0.186
UTAH,DAGGETT,49,009,108,0.216,77,0.161,-31,-0.055
UTAH,DAVIS,49,011,20893,0.191,28776,0.205,7883,0.014
UTAH,DUCHESNE,49,013,738,0.133,500,0.072,-238,-0.061
UTAH,EMERY,49,015,831,0.178,380,0.088,-451,-0.090
UTAH,GARFIELD,49,017,264,0.122,358,0.153,94,0.031
UTAH,GRAND,49,019,1858,0.446,1960,0.426,102,-0.020
UTAH,IRON,49,021,2267,0.147,2450,0.137,183,-0.010
UTAH,JUAB,49,023,605,0.177,442,0.105,-163,-0.072
UTAH,KANE,49,025,576,0.189,741,0.209,165,0.020
UTAH,MILLARD,49,027,626,0.128,431,0.082,-195,-0.046
UTAH,MORGAN,49,029,472,0.123,577,0.111,105,-0.012
UTAH,PIUTE,49,031,123,0.159,47,0.064,-76,-0.095
UTAH,RICH,49,033,109,0.105,104,0.094,-5,-0.011
UTAH,SALTLAKE,49,035,135949,0.375,175863,0.415,39914,0.040
UTAH,SANJUAN,49,037,1906,0.383,2042,0.369,136,-0.014
UTAH,SANPETE,49,039,1189,0.140,1061,0.104,-128,-0.036
UTAH,SEVIER,49,041,920,0.120,695,0.080,-225,-0.040
UTAH,SUMMIT,49,043,6977,0.456,10503,0.503,3526,0.047
UTAH,TOOELE,49,045,4130,0.248,4573,0.208,443,-0.040
UTAH,UINTAH,49,047,1266,0.127,995,0.077,-271,-0.050
UTAH,UTAH,49,049,17357,0.116,28522,0.140,11165,0.024
UTAH,WASATCH,49,051,1854,0.247,3063,0.250,1209,0.003
UTAH,WASHINGTON,49,053,7513,0.171,10288,0.165,2775,-0.006
UTAH,WAYNE,49,055,279,0.205,271,0.190,-8,-0.015
UTAH,WEBER,49,057,19862,0.273,23131,0.269,3269,-0.004
VERMONT,WINDHAM,50,025,15489,0.664,14340,0.634,-1149,-0.030
VERMONT,CHITTENDEN,50,007,49369,0.635,54814,0.657,5445,0.022
VERMONT,LAMOILLE,50,015,7636,0.627,7241,0.567,-395,-0.060
VERMONT,WASHINGTON,50,023,19177,0.610,18594,0.598,-583,-0.012
VERMONT,WINDSOR,50,027,18561,0.603,17556,0.587,-1005,-0.016
VERMONT,ADDISON,50,001,11147,0.600,11219,0.590,72,-0.010
VERMONT,BENNINGTON,50,003,11069,0.581,9539,0.549,-1530,-0.032
VERMONT,GRANDISLE,50,013,2246,0.551,2094,0.510,-152,-0.041
VERMONT,ORANGE,50,017,8159,0.548,7541,0.515,-618,-0.033
VERMONT,FRANKLIN,50,011,10598,0.532,9351,0.437,-1247,-0.095
VERMONT,ORLEANS,50,019,6330,0.517,5185,0.430,-1145,-0.087
VERMONT,RUTLAND,50,021,15904,0.513,13635,0.460,-2269,-0.053
VERMONT,CALEDONIA,50,005,7106,0.500,6445,0.458,-661,-0.042
VERMONT,ESSEX,50,009,1276,0.434,1019,0.348,-257,-0.086
VIRGINIA,ACCOMACK,51,001,5518,0.413,6740,0.426,1222,0.013
VIRGINIA,ALBEMARLE,51,003,22088,0.505,33345,0.588,11257,0.083
VIRGINIA,ALLEGHANY,51,005,3203,0.445,2166,0.296,-1037,-0.149
VIRGINIA,AMELIA,51,007,1862,0.345,2128,0.302,266,-0.043
VIRGINIA,AMHERST,51,009,4866,0.383,5057,0.328,191,-0.055
VIRGINIA,APPOMATTOX,51,011,2191,0.329,2023,0.253,-168,-0.076
VIRGINIA,ARLINGTON,51,013,63987,0.676,92016,0.758,28029,0.082
VIRGINIA,AUGUSTA,51,015,7019,0.236,8177,0.225,1158,-0.011
VIRGINIA,BATH,51,017,828,0.363,603,0.268,-225,-0.095
VIRGINIA,BEDFORD,51,019,9102,0.290,9768,0.230,666,-0.060
VIRGINIA,BLAND,51,021,846,0.295,453,0.144,-393,-0.151
VIRGINIA,BOTETOURT,51,023,4801,0.304,4494,0.240,-307,-0.064
VIRGINIA,BRUNSWICK,51,025,4062,0.586,4481,0.584,419,-0.002
VIRGINIA,BUCHANAN,51,027,5275,0.537,1721,0.186,-3554,-0.351
VIRGINIA,BUCKINGHAM,51,029,2789,0.463,3128,0.429,339,-0.034
VIRGINIA,CAMPBELL,51,031,6862,0.298,6664,0.242,-198,-0.056
VIRGINIA,CAROLINE,51,033,4878,0.490,6432,0.451,1554,-0.039
VIRGINIA,CARROLL,51,035,3888,0.321,2559,0.187,-1329,-0.134
VIRGINIA,CHARLESCITY,51,036,2155,0.627,2496,0.608,341,-0.019
VIRGINIA,CHARLOTTE,51,037,2223,0.409,2155,0.371,-68,-0.038
VIRGINIA,CHESTERFIELD,51,041,49346,0.369,81074,0.460,31728,0.091
VIRGINIA,CLARKE,51,043,2699,0.415,3051,0.371,352,-0.044
VIRGINIA,CRAIG,51,045,901,0.344,541,0.194,-360,-0.150
VIRGINIA,CULPEPER,51,047,5476,0.351,7759,0.349,2283,-0.002
VIRGINIA,CUMBERLAND,51,049,1721,0.417,2036,0.415,315,-0.002
VIRGINIA,DICKENSON,51,051,3761,0.508,1335,0.207,-2426,-0.301
VIRGINIA,DINWIDDIE,51,053,4569,0.422,5765,0.425,1196,0.003
VIRGINIA,ESSEX,51,057,2007,0.462,2542,0.473,535,0.011
VIRGINIA,FAIRFAX,51,059,245671,0.532,355133,0.644,109462,0.112
VIRGINIA,FAUQUIER,51,061,10712,0.358,12971,0.346,2259,-0.012
VIRGINIA,FLOYD,51,063,2488,0.369,2300,0.286,-188,-0.083
VIRGINIA,FLUVANNA,51,065,4415,0.403,5760,0.424,1345,0.021
VIRGINIA,FRANKLIN,51,067,8002,0.360,7257,0.269,-745,-0.091
VIRGINIA,FREDERICK,51,069,8853,0.310,11932,0.295,3079,-0.015
VIRGINIA,GILES,51,071,3047,0.406,1950,0.237,-1097,-0.169
VIRGINIA,GLOUCESTER,51,073,5105,0.313,5404,0.275,299,-0.038
VIRGINIA,GOOCHLAND,51,075,3583,0.347,4889,0.348,1306,0.001
VIRGINIA,GRAYSON,51,077,2430,0.340,1407,0.193,-1023,-0.147
VIRGINIA,GREENE,51,079,2240,0.323,2924,0.304,684,-0.019
VIRGINIA,GREENSVILLE,51,081,2514,0.590,2558,0.586,44,-0.004
VIRGINIA,HALIFAX,51,083,6220,0.424,6897,0.406,677,-0.018
VIRGINIA,HANOVER,51,085,13941,0.281,19382,0.309,5441,0.028
VIRGINIA,HENRICO,51,087,60864,0.456,93935,0.574,33071,0.118
VIRGINIA,HENRY,51,089,9851,0.420,8198,0.340,-1653,-0.080
VIRGINIA,HIGHLAND,51,091,522,0.343,371,0.267,-151,-0.076
VIRGINIA,ISLEOFWIGHT,51,093,5871,0.370,7881,0.374,2010,0.004
VIRGINIA,JAMESCITY,51,095,11934,0.384,19105,0.443,7171,0.059
VIRGINIA,KINGANDQUEEN,51,097,1506,0.458,1468,0.398,-38,-0.060
VIRGINIA,KINGGEORGE,51,099,2739,0.346,4007,0.333,1268,-0.013
VIRGINIA,KINGWILLIAM,51,101,2436,0.354,2760,0.302,324,-0.052
VIRGINIA,LANCASTER,51,103,2477,0.398,2869,0.432,392,0.034
VIRGINIA,LEE,51,105,4005,0.410,1627,0.173,-2378,-0.237
VIRGINIA,LOUDOUN,51,107,47271,0.436,100795,0.551,53524,0.115
VIRGINIA,LOUISA,51,109,4844,0.402,6212,0.353,1368,-0.049
VIRGINIA,LUNENBURG,51,111,2362,0.450,2227,0.399,-135,-0.051
VIRGINIA,MADISON,51,113,2176,0.377,2203,0.316,27,-0.061
VIRGINIA,MATHEWS,51,115,1589,0.310,1563,0.294,-26,-0.016
VIRGINIA,MECKLENBURG,51,117,5293,0.414,6285,0.421,992,0.007
VIRGINIA,MIDDLESEX,51,119,1914,0.356,2108,0.350,194,-0.006
VIRGINIA,MONTGOMERY,51,121,14128,0.448,20021,0.465,5893,0.017
VIRGINIA,NELSON,51,125,3543,0.496,3689,0.444,146,-0.052
VIRGINIA,NEWKENT,51,127,2443,0.307,3546,0.290,1103,-0.017
VIRGINIA,NORTHAMPTON,51,131,2775,0.505,3255,0.528,480,0.023
VIRGINIA,NORTHUMBERLAND,51,133,2548,0.398,2852,0.386,304,-0.012
VIRGINIA,NOTTOWAY,51,135,2635,0.437,2829,0.419,194,-0.018
VIRGINIA,ORANGE,51,137,5015,0.388,5957,0.345,942,-0.043
VIRGINIA,PAGE,51,139,3324,0.346,2514,0.234,-810,-0.112
VIRGINIA,PATRICK,51,141,2572,0.313,1768,0.207,-804,-0.106
VIRGINIA,PITTSYLVANIA,51,143,9274,0.338,9199,0.291,-75,-0.047
VIRGINIA,POWHATAN,51,145,3112,0.256,4060,0.240,948,-0.016
VIRGINIA,PRINCEEDWARD,51,147,3632,0.496,4591,0.502,959,0.006
VIRGINIA,PRINCEGEORGE,51,149,5066,0.382,6419,0.397,1353,0.015
VIRGINIA,PRINCEWILLIAM,51,153,61271,0.464,113144,0.576,51873,0.112
VIRGINIA,PULASKI,51,155,5310,0.373,4172,0.275,-1138,-0.098
VIRGINIA,RAPPAHANNOCK,51,157,1837,0.454,1747,0.390,-90,-0.064
VIRGINIA,RICHMOND,51,159,1243,0.370,1347,0.368,104,-0.002
VIRGINIA,ROANOKE,51,161,16082,0.342,17200,0.334,1118,-0.008
VIRGINIA,ROCKBRIDGE,51,163,3627,0.395,3508,0.325,-119,-0.070
VIRGINIA,ROCKINGHAM,51,165,7273,0.249,9366,0.250,2093,0.001
VIRGINIA,RUSSELL,51,167,5167,0.452,2330,0.190,-2837,-0.262
VIRGINIA,SCOTT,51,169,3324,0.334,1581,0.157,-1743,-0.177
VIRGINIA,SHENANDOAH,51,171,5186,0.302,5273,0.257,87,-0.045
VIRGINIA,SMYTH,51,173,4143,0.336,2665,0.207,-1478,-0.129
VIRGINIA,SOUTHAMPTON,51,175,3431,0.458,3595,0.405,164,-0.053
VIRGINIA,SPOTSYLVANIA,51,177,16623,0.366,24207,0.387,7584,0.021
VIRGINIA,STAFFORD,51,179,17208,0.374,27908,0.423,10700,0.049
VIRGINIA,SURRY,51,181,1954,0.555,2272,0.537,318,-0.018
VIRGINIA,SUSSEX,51,183,2420,0.557,2879,0.571,459,0.014
VIRGINIA,TAZEWELL,51,185,7184,0.411,2895,0.156,-4289,-0.255
VIRGINIA,WARREN,51,187,5241,0.373,5169,0.288,-72,-0.085
VIRGINIA,WASHINGTON,51,191,7339,0.326,5553,0.215,-1786,-0.111
VIRGINIA,WESTMORELAND,51,193,3370,0.492,3836,0.447,466,-0.045
VIRGINIA,WISE,51,195,5802,0.405,2701,0.178,-3101,-0.227
VIRGINIA,WYTHE,51,197,3581,0.310,2770,0.208,-811,-0.102
VIRGINIA,YORK,51,199,10276,0.344,12999,0.381,2723,0.037
VIRGINIA,ALEXANDRIACITY,51,510,41116,0.668,57242,0.756,16126,0.088
VIRGINIA,BEDFORDCITY,51,515,1042,0.410,57242,0.756,16126,0.088
VIRGINIA,BRISTOLCITY,51,520,2400,0.357,1835,0.261,-565,-0.096
VIRGINIA,BUENAVISTACITY,51,530,936,0.392,693,0.288,-243,-0.104
VIRGINIA,CHARLOTTESVILLECITY,51,540,11088,0.718,17901,0.797,6813,0.079
VIRGINIA,CHESAPEAKECITY,51,550,38744,0.423,52627,0.467,13883,0.044
VIRGINIA,COLONIALHEIGHTSCITY,51,570,2061,0.250,2367,0.280,306,0.030
VIRGINIA,COVINGTONCITY,51,580,1179,0.512,914,0.384,-265,-0.128
VIRGINIA,DANVILLECITY,51,590,9436,0.494,11059,0.584,1623,0.090
VIRGINIA,EMPORIACITY,51,595,1247,0.561,1530,0.647,283,0.086
VIRGINIA,FAIRFAXCITY,51,600,5395,0.512,7367,0.612,1972,0.100
VIRGINIA,FALLSCHURCHCITY,51,610,3944,0.647,5819,0.750,1875,0.103
VIRGINIA,FRANKLINCITY,51,620,1910,0.540,2519,0.620,609,0.080
VIRGINIA,FREDERICKSBURGCITY,51,630,4085,0.542,6707,0.596,2622,0.054
VIRGINIA,GALAXCITY,51,640,987,0.423,681,0.287,-306,-0.136
VIRGINIA,HAMPTONCITY,51,650,32016,0.574,41312,0.663,9296,0.089
VIRGINIA,HARRISONBURGCITY,51,660,4726,0.428,10212,0.568,5486,0.140
VIRGINIA,HOPEWELLCITY,51,670,3573,0.450,4724,0.524,1151,0.074
VIRGINIA,LEXINGTONCITY,51,678,1340,0.570,1514,0.614,174,0.044
VIRGINIA,LYNCHBURGCITY,51,680,11727,0.445,14792,0.415,3065,-0.030
VIRGINIA,MANASSASCITY,51,683,5562,0.431,8423,0.547,2861,0.116
VIRGINIA,MANASSASPARKCITY,51,685,1498,0.450,3204,0.612,1706,0.162
VIRGINIA,MARTINSVILLECITY,51,690,3036,0.542,3533,0.598,497,0.056
VIRGINIA,NEWPORTNEWSCITY,51,700,35319,0.520,45618,0.603,10299,0.083
VIRGINIA,NORFOLKCITY,51,710,43518,0.617,57023,0.684,13505,0.067
VIRGINIA,NORTONCITY,51,720,725,0.482,383,0.262,-342,-0.220
VIRGINIA,PETERSBURGCITY,51,730,9682,0.810,12021,0.872,2339,0.062
VIRGINIA,POQUOSONCITY,51,735,1424,0.220,1601,0.223,177,0.003
VIRGINIA,PORTSMOUTHCITY,51,740,24112,0.610,28497,0.659,4385,0.049
VIRGINIA,RADFORDCITY,51,750,2244,0.463,2925,0.481,681,0.018
VIRGINIA,RICHMONDCITY,51,760,52167,0.702,81259,0.786,29092,0.084
VIRGINIA,ROANOKECITY,51,770,18862,0.524,22286,0.565,3424,0.041
VIRGINIA,SALEMCITY,51,775,4254,0.370,4202,0.344,-52,-0.026
VIRGINIA,STAUNTONCITY,51,790,3756,0.390,5333,0.474,1577,0.084
VIRGINIA,SUFFOLKCITY,51,800,15233,0.473,23280,0.538,8047,0.065
VIRGINIA,VIRGINIABEACHCITY,51,810,70666,0.402,91032,0.448,20366,0.046
VIRGINIA,WAYNESBOROCITY,51,820,2792,0.351,3764,0.409,972,0.058
VIRGINIA,WILLIAMSBURGCITY,51,830,2216,0.513,5206,0.683,2990,0.170
VIRGINIA,WINCHESTERCITY,51,840,3967,0.425,5164,0.484,1197,0.059
WASHINGTON,ADAMS,53,001,1315,0.256,1299,0.273,-16,0.017
WASHINGTON,ASOTIN,53,003,3319,0.378,3134,0.314,-185,-0.064
WASHINGTON,BENTON,53,005,21549,0.322,26360,0.315,4811,-0.007
WASHINGTON,CHELAN,53,007,10471,0.356,13032,0.378,2561,0.022
WASHINGTON,CLALLAM,53,009,17049,0.464,17677,0.436,628,-0.028
WASHINGTON,CLARK,53,011,79538,0.467,92757,0.445,13219,-0.022
WASHINGTON,COLUMBIA,53,013,605,0.287,526,0.236,-79,-0.051
WASHINGTON,COWLITZ,53,015,21589,0.508,17908,0.380,-3681,-0.128
WASHINGTON,DOUGLAS,53,017,4306,0.322,4918,0.309,612,-0.013
WASHINGTON,FERRY,53,019,1201,0.359,1098,0.301,-103,-0.058
WASHINGTON,FRANKLIN,53,021,5188,0.321,8886,0.361,3698,0.040
WASHINGTON,GARFIELD,53,023,365,0.277,279,0.220,-86,-0.057
WASHINGTON,GRANT,53,025,7779,0.299,7810,0.267,31,-0.032
WASHINGTON,GRAYSHARBOR,53,027,14583,0.522,12020,0.410,-2563,-0.112
WASHINGTON,ISLAND,53,029,18216,0.472,20960,0.473,2744,0.001
WASHINGTON,JEFFERSON,53,031,11610,0.624,12656,0.606,1046,-0.018
WASHINGTON,KING,53,033,580378,0.650,718322,0.698,137944,0.048
WASHINGTON,KITSAP,53,035,60796,0.513,63156,0.490,2360,-0.023
WASHINGTON,KITTITAS,53,037,6731,0.418,7489,0.388,758,-0.030
WASHINGTON,KLICKITAT,53,039,4036,0.437,4194,0.379,158,-0.058
WASHINGTON,LEWIS,53,041,10726,0.331,9654,0.274,-1072,-0.057
WASHINGTON,LINCOLN,53,043,1706,0.294,1244,0.212,-462,-0.082
WASHINGTON,MASON,53,045,12894,0.508,11993,0.414,-901,-0.094
WASHINGTON,OKANOGAN,53,047,6309,0.386,6298,0.364,-11,-0.022
WASHINGTON,PACIFIC,53,049,5570,0.534,4620,0.421,-950,-0.113
WASHINGTON,PENDOREILLE,53,051,2310,0.373,1934,0.276,-376,-0.097
WASHINGTON,PIERCE,53,053,158231,0.505,172538,0.479,14307,-0.026
WASHINGTON,SANJUAN,53,055,6589,0.653,7172,0.644,583,-0.009
WASHINGTON,SKAGIT,53,057,25131,0.481,26690,0.460,1559,-0.021
WASHINGTON,SKAMANIA,53,059,2374,0.460,2232,0.383,-142,-0.077
WASHINGTON,SNOHOMISH,53,061,156468,0.530,185227,0.522,28759,-0.008
WASHINGTON,SPOKANE,53,063,87490,0.432,93767,0.397,6277,-0.035
WASHINGTON,STEVENS,53,065,6822,0.335,5767,0.247,-1055,-0.088
WASHINGTON,THURSTON,53,067,62650,0.555,68798,0.513,6148,-0.042
WASHINGTON,WAHKIAKUM,53,069,1021,0.457,832,0.343,-189,-0.114
WASHINGTON,WALLAWALLA,53,071,8257,0.360,9694,0.370,1437,0.010
WASHINGTON,WHATCOM,53,073,48268,0.534,60340,0.532,12072,-0.002
WASHINGTON,WHITMAN,53,075,8287,0.460,8146,0.452,-141,-0.008
WASHINGTON,YAKIMA,53,077,28474,0.391,31291,0.392,2817,0.001
WEST-VIRGINIA,BARBOUR,54,001,2636,0.396,1222,0.200,-1414,-0.196
WEST-VIRGINIA,BERKELEY,54,003,11888,0.362,12321,0.284,433,-0.078
WEST-VIRGINIA,BOONE,54,005,5890,0.583,1790,0.204,-4100,-0.379
WEST-VIRGINIA,BRAXTON,54,007,3014,0.502,1321,0.259,-1693,-0.243
WEST-VIRGINIA,BROOKE,54,009,5460,0.511,2568,0.265,-2892,-0.246
WEST-VIRGINIA,CABELL,54,011,16328,0.436,11447,0.341,-4881,-0.095
WEST-VIRGINIA,CALHOUN,54,013,1253,0.439,456,0.173,-797,-0.266
WEST-VIRGINIA,CLAY,54,015,1824,0.451,568,0.190,-1256,-0.261
WEST-VIRGINIA,DODDRIDGE,54,017,792,0.250,362,0.126,-430,-0.124
WEST-VIRGINIA,FAYETTE,54,019,8860,0.529,4290,0.277,-4570,-0.252
WEST-VIRGINIA,GILMER,54,021,1153,0.406,545,0.211,-608,-0.195
WEST-VIRGINIA,GRANT,54,023,944,0.190,512,0.103,-432,-0.087
WEST-VIRGINIA,GREENBRIER,54,025,4988,0.422,3765,0.265,-1223,-0.157
WEST-VIRGINIA,HAMPSHIRE,54,027,2444,0.307,1580,0.182,-864,-0.125
WEST-VIRGINIA,HANCOCK,54,029,6829,0.482,3262,0.255,-3567,-0.227
WEST-VIRGINIA,HARDY,54,031,1606,0.307,1155,0.204,-451,-0.103
WEST-VIRGINIA,HARRISON,54,033,13102,0.433,7694,0.271,-5408,-0.162
WEST-VIRGINIA,JACKSON,54,035,5332,0.410,2663,0.216,-2669,-0.194
WEST-VIRGINIA,JEFFERSON,54,037,9202,0.465,9518,0.388,316,-0.077
WEST-VIRGINIA,KANAWHA,54,039,42321,0.489,28263,0.368,-14058,-0.121
WEST-VIRGINIA,LEWIS,54,041,1863,0.343,1347,0.194,-516,-0.149
WEST-VIRGINIA,LINCOLN,54,043,2378,0.519,1459,0.204,-919,-0.315
WEST-VIRGINIA,LOGAN,54,045,7760,0.541,2092,0.168,-5668,-0.373
WEST-VIRGINIA,MARION,54,049,12082,0.482,6964,0.298,-5118,-0.184
WEST-VIRGINIA,MARSHALL,54,051,6379,0.427,2918,0.219,-3461,-0.208
WEST-VIRGINIA,MASON,54,053,5374,0.451,2081,0.203,-3293,-0.248
WEST-VIRGINIA,MCDOWELL,54,047,4464,0.618,1438,0.230,-3026,-0.388
WEST-VIRGINIA,MERCER,54,055,9052,0.409,4704,0.203,-4348,-0.206
WEST-VIRGINIA,MINERAL,54,057,3444,0.308,2050,0.176,-1394,-0.132
WEST-VIRGINIA,MINGO,54,059,5912,0.562,1370,0.144,-4542,-0.418
WEST-VIRGINIA,MONONGALIA,54,061,16136,0.476,14699,0.400,-1437,-0.076
WEST-VIRGINIA,MONROE,54,063,2321,0.389,1111,0.190,-1210,-0.199
WEST-VIRGINIA,MORGAN,54,065,2086,0.341,1573,0.203,-513,-0.138
WEST-VIRGINIA,NICHOLAS,54,067,4718,0.463,1840,0.192,-2878,-0.271
WEST-VIRGINIA,OHIO,54,069,8406,0.418,5493,0.302,-2913,-0.116
WEST-VIRGINIA,PENDLETON,54,071,1367,0.390,729,0.224,-638,-0.166
WEST-VIRGINIA,PLEASANTS,54,073,1333,0.395,621,0.195,-712,-0.200
WEST-VIRGINIA,POCAHONTAS,54,075,1565,0.402,928,0.253,-637,-0.149
WEST-VIRGINIA,PRESTON,54,077,3944,0.332,2470,0.194,-1474,-0.138
WEST-VIRGINIA,PUTNAM,54,079,9223,0.370,5884,0.233,-3339,-0.137
WEST-VIRGINIA,RALEIGH,54,081,11522,0.387,6443,0.216,-5079,-0.171
WEST-VIRGINIA,RANDOLPH,54,083,4880,0.426,2735,0.249,-2145,-0.177
WEST-VIRGINIA,RITCHIE,54,085,1060,0.255,496,0.121,-564,-0.134
WEST-VIRGINIA,ROANE,54,087,2599,0.428,1222,0.230,-1377,-0.198
WEST-VIRGINIA,SUMMERS,54,089,2489,0.453,1190,0.243,-1299,-0.210
WEST-VIRGINIA,TAYLOR,54,091,1943,0.418,1491,0.226,-452,-0.192
WEST-VIRGINIA,TUCKER,54,093,1382,0.389,751,0.215,-631,-0.174
WEST-VIRGINIA,TYLER,54,095,1386,0.330,507,0.137,-879,-0.193
WEST-VIRGINIA,UPSHUR,54,097,2998,0.326,1766,0.190,-1232,-0.136
WEST-VIRGINIA,WAYNE,54,099,8363,0.452,3357,0.219,-5006,-0.233
WEST-VIRGINIA,WEBSTER,54,101,1943,0.529,556,0.185,-1387,-0.344
WEST-VIRGINIA,WETZEL,54,103,3293,0.474,1359,0.215,-1934,-0.259
WEST-VIRGINIA,WIRT,54,105,714,0.341,386,0.159,-328,-0.182
WEST-VIRGINIA,WOOD,54,107,13111,0.363,8400,0.233,-4711,-0.130
WEST-VIRGINIA,WYOMING,54,109,3666,0.425,1062,0.135,-2604,-0.290
WISCONSIN,ADAMS,55,001,5447,0.521,3745,0.370,-1702,-0.151
WISCONSIN,ASHLAND,55,003,5805,0.631,4226,0.526,-1579,-0.105
WISCONSIN,BARRON,55,005,11696,0.489,7889,0.348,-3807,-0.141
WISCONSIN,BAYFIELD,55,007,5845,0.603,4953,0.515,-892,-0.088
WISCONSIN,BROWN,55,009,54935,0.446,53382,0.414,-1553,-0.032
WISCONSIN,BUFFALO,55,011,3998,0.527,2525,0.362,-1473,-0.165
WISCONSIN,BURNETT,55,013,4499,0.483,2949,0.337,-1550,-0.146
WISCONSIN,CALUMET,55,015,10290,0.407,9642,0.363,-648,-0.044
WISCONSIN,CHIPPEWA,55,017,14751,0.483,11887,0.377,-2864,-0.106
WISCONSIN,CLARK,55,019,6966,0.461,4221,0.309,-2745,-0.152
WISCONSIN,COLUMBIA,55,021,14300,0.484,13528,0.456,-772,-0.028
WISCONSIN,CRAWFORD,55,023,4656,0.550,3419,0.442,-1237,-0.108
WISCONSIN,DANE,55,025,181052,0.660,217697,0.704,36645,0.044
WISCONSIN,DODGE,55,027,16690,0.376,13968,0.324,-2722,-0.052
WISCONSIN,DOOR,55,029,8367,0.478,8014,0.456,-353,-0.022
WISCONSIN,DOUGLAS,55,031,16537,0.657,11357,0.504,-5180,-0.153
WISCONSIN,DUNN,55,033,12039,0.520,9034,0.409,-3005,-0.111
WISCONSIN,EAUCLAIRE,55,035,30068,0.542,27340,0.497,-2728,-0.045
WISCONSIN,FLORENCE,55,037,993,0.365,665,0.250,-328,-0.115
WISCONSIN,FONDDULAC,55,039,19216,0.362,17387,0.336,-1829,-0.026
WISCONSIN,FOREST,55,041,2509,0.487,1579,0.347,-930,-0.140
WISCONSIN,GRANT,55,043,12864,0.509,10051,0.412,-2813,-0.097
WISCONSIN,GREEN,55,045,9575,0.525,9122,0.480,-453,-0.045
WISCONSIN,GREENLAKE,55,047,3605,0.354,2693,0.286,-912,-0.068
WISCONSIN,IOWA,55,049,7122,0.568,6669,0.543,-453,-0.025
WISCONSIN,IRON,55,051,1956,0.504,1275,0.363,-681,-0.141
WISCONSIN,JACKSON,55,053,5249,0.540,3818,0.412,-1431,-0.128
WISCONSIN,JEFFERSON,55,055,17925,0.426,16569,0.384,-1356,-0.042
WISCONSIN,JUNEAU,55,057,5734,0.463,4073,0.347,-1661,-0.116
WISCONSIN,KENOSHA,55,059,40107,0.525,35799,0.469,-4308,-0.056
WISCONSIN,KEWAUNEE,55,061,5175,0.459,3627,0.337,-1548,-0.122
WISCONSIN,LACROSSE,55,063,33170,0.534,32406,0.509,-764,-0.025
WISCONSIN,LAFAYETTE,55,065,4402,0.525,3288,0.429,-1114,-0.096
WISCONSIN,LANGLADE,55,067,4751,0.429,3250,0.319,-1501,-0.110
WISCONSIN,LINCOLN,55,069,7484,0.477,5371,0.365,-2113,-0.112
WISCONSIN,MANITOWOC,55,071,20652,0.468,14538,0.356,-6114,-0.112
WISCONSIN,MARATHON,55,073,30899,0.454,26481,0.381,-4418,-0.073
WISCONSIN,MARINETTE,55,075,10190,0.458,6409,0.315,-3781,-0.143
WISCONSIN,MARQUETTE,55,077,3785,0.447,2808,0.356,-977,-0.091
WISCONSIN,MENOMINEE,55,078,1412,0.826,1002,0.766,-410,-0.060
WISCONSIN,MILWAUKEE,55,079,297653,0.617,288822,0.655,-8831,0.038
WISCONSIN,MONROE,55,081,8973,0.459,7052,0.358,-1921,-0.101
WISCONSIN,OCONTO,55,083,8534,0.431,5940,0.294,-2594,-0.137
WISCONSIN,ONEIDA,55,085,10464,0.475,8109,0.377,-2355,-0.098
WISCONSIN,OUTAGAMIE,55,087,40169,0.446,38068,0.405,-2101,-0.041
WISCONSIN,OZAUKEE,55,089,17714,0.334,20170,0.370,2456,0.036
WISCONSIN,PEPIN,55,091,2181,0.536,1344,0.360,-837,-0.176
WISCONSIN,PIERCE,55,093,11176,0.511,8399,0.393,-2777,-0.118
WISCONSIN,POLK,55,095,11173,0.475,7565,0.333,-3608,-0.142
WISCONSIN,PORTAGE,55,097,21861,0.561,18529,0.480,-3332,-0.081
WISCONSIN,PRICE,55,099,4349,0.496,2667,0.352,-1682,-0.144
WISCONSIN,RACINE,55,101,48229,0.475,42641,0.452,-5588,-0.023
WISCONSIN,RICHLAND,55,103,4501,0.478,3569,0.442,-932,-0.036
WISCONSIN,ROCK,55,105,46598,0.579,39339,0.517,-7259,-0.062
WISCONSIN,RUSK,55,107,3820,0.482,2171,0.306,-1649,-0.176
WISCONSIN,STCROIX,55,109,18784,0.449,17482,0.368,-1302,-0.081
WISCONSIN,SAUK,55,111,15708,0.516,14690,0.468,-1018,-0.048
WISCONSIN,SAWYER,55,113,4411,0.467,3503,0.383,-908,-0.084
WISCONSIN,SHAWANO,55,115,8657,0.412,6068,0.306,-2589,-0.106
WISCONSIN,SHEBOYGAN,55,117,27608,0.441,23000,0.385,-4608,-0.056
WISCONSIN,TAYLOR,55,119,3829,0.401,2393,0.253,-1436,-0.148
WISCONSIN,TREMPEALEAU,55,121,8075,0.574,5636,0.412,-2439,-0.162
WISCONSIN,VERNON,55,123,7924,0.534,6371,0.446,-1553,-0.088
WISCONSIN,VILAS,55,125,5713,0.408,4770,0.350,-943,-0.058
WISCONSIN,WALWORTH,55,127,19177,0.396,18710,0.364,-467,-0.032
WISCONSIN,WASHBURN,55,129,4705,0.492,3282,0.357,-1423,-0.135
WISCONSIN,WASHINGTON,55,131,21234,0.293,20852,0.272,-382,-0.021
WISCONSIN,WAUKESHA,55,133,73626,0.320,79224,0.333,5598,0.013
WISCONSIN,WAUPACA,55,135,10792,0.400,8451,0.324,-2341,-0.076
WISCONSIN,WAUSHARA,55,137,5257,0.429,3791,0.314,-1466,-0.115
WISCONSIN,WINNEBAGO,55,139,40943,0.462,37047,0.425,-3896,-0.037
WISCONSIN,WOOD,55,141,18950,0.473,14225,0.376,-4725,-0.097
WYOMING,ALBANY,56,001,7032,0.430,6890,0.404,-142,-0.026
WYOMING,BH,56,003,960,0.182,604,0.114,-356,-0.068
WYOMING,CAMP,56,005,2464,0.163,1324,0.073,-1140,-0.090
WYOMING,CARBON,56,007,2157,0.305,1279,0.201,-878,-0.104
WYOMING,CONVERSE,56,009,1183,0.207,668,0.100,-515,-0.107
WYOMING,CROOK,56,011,500,0.147,273,0.071,-227,-0.076
WYOMING,FREMONT,56,013,5337,0.313,4200,0.247,-1137,-0.066
WYOMING,GOSHEN,56,015,1566,0.270,924,0.159,-642,-0.111
WYOMING,HOTSPRINGS,56,017,623,0.251,400,0.155,-223,-0.096
WYOMING,JOHNSON,56,019,736,0.182,638,0.144,-98,-0.038
WYOMING,LARAMIE,56,021,13170,0.331,11573,0.282,-1597,-0.049
WYOMING,LINCOLN,56,023,1363,0.172,1105,0.125,-258,-0.047
WYOMING,NATRONA,56,025,9852,0.308,6577,0.197,-3275,-0.112
WYOMING,NIOBRARA,56,027,230,0.175,115,0.088,-115,-0.087
WYOMING,PARK,56,029,2939,0.212,2535,0.168,-404,-0.044
WYOMING,PLATTE,56,031,1318,0.291,719,0.159,-599,-0.132
WYOMING,SHER,56,033,4041,0.290,2927,0.202,-1114,-0.088
WYOMING,SUB,56,035,730,0.200,644,0.147,-86,-0.053
WYOMING,SWEETWATER,56,037,5201,0.321,3231,0.189,-1970,-0.132
WYOMING,TETON,56,039,5971,0.527,7314,0.579,1343,0.052
WYOMING,UINTA,56,041,1812,0.225,1202,0.142,-610,-0.083
WYOMING,WASH,56,043,855,0.208,532,0.139,-323,-0.069
WYOMING,WESTON,56,045,580,0.171,299,0.085,-281,-0.086
